name,tot,male,female,is_male,is_female
giuseppe,204446,204399,47,True,False
giovanni,152660,152607,53,True,False
antonio,149463,149458,5,True,False
francesco,116954,116951,3,True,False
mario,93718,93718,0,True,False
luigi,93106,93094,12,True,False
roberto,73949,73949,0,True,False
paolo,71182,71177,5,True,False
maria,69007,77,68930,False,True
angelo,68449,68433,16,True,False
franco,60392,60392,0,True,False
marco,59561,59551,10,True,False
domenico,58402,58402,0,True,False
vincenzo,58268,58268,0,True,False
pietro,58140,58140,0,True,False
salvatore,56522,56513,9,True,False
carlo,54302,54294,8,True,False
michele,49578,49560,18,True,False
claudio,46951,46948,3,True,False
giorgio,44768,44768,0,True,False
andrea,44570,44455,115,True,False
sergio,41658,41658,0,True,False
alessandro,41641,41641,0,True,False
massimo,41629,41628,1,True,False
stefano,40747,40744,3,True,False
bruno,40455,40455,0,True,False
mauro,39619,39612,7,True,False
luciano,38301,38301,0,True,False
maurizio,37692,37692,0,True,False
alberto,36350,36346,4,True,False
nicola,35442,35383,59,True,False
giancarlo,33738,33738,0,True,False
enrico,30371,30364,7,True,False
pasquale,28026,28014,12,True,False
gianfranco,26854,26853,1,True,False
fabio,26528,26528,0,True,False
renato,25268,25268,0,True,False
luca,25189,25164,25,True,False
aldo,25091,25086,5,True,False
anna,24648,0,24648,False,True
lorenzo,24333,24333,0,True,False
daniele,22127,22121,6,True,False
antonino,21896,21892,4,True,False
giacomo,21763,21763,0,True,False
gian,21693,21682,11,True,False
vittorio,21205,21205,0,True,False
raffaele,20950,20948,2,True,False
fabrizio,20538,20533,5,True,False
renzo,17778,17774,4,True,False
guido,17381,17381,0,True,False
enzo,17073,17073,0,True,False
gabriele,17043,17028,15,True,False
adriano,16761,16761,0,True,False
riccardo,16334,16334,0,True,False
giuliano,16170,16170,0,True,False
piero,15949,15949,0,True,False
gianni,15898,15883,15,True,False
pier,15826,15826,0,True,False
gaetano,15764,15764,0,True,False
dario,15288,15288,0,True,False
emilio,15277,15267,10,True,False
davide,15124,15119,5,True,False
rocco,15076,15076,0,True,False
filippo,14798,14793,5,True,False
vito,14541,14538,3,True,False
silvano,14516,14516,0,True,False
marcello,14476,14476,0,True,False
matteo,14113,14113,0,True,False
carmine,13955,13950,5,True,False
pierluigi,13886,13886,0,True,False
giulio,13820,13820,0,True,False
paola,13803,0,13803,False,True
sandro,13364,13364,0,True,False
cesare,13294,13288,6,True,False
umberto,13078,13078,0,True,False
alfredo,12471,12471,0,True,False
leonardo,12269,12269,0,True,False
carmelo,12203,12198,5,True,False
walter,11947,11947,0,True,False
flavio,11666,11661,5,True,False
fausto,11613,11613,0,True,False
elio,11483,11483,0,True,False
armando,11401,11396,5,True,False
silvio,11362,11362,0,True,False
eugenio,11144,11144,0,True,False
laura,10897,0,10897,False,True
annamaria,10865,0,10865,False,True
gino,10727,10723,4,True,False
daniela,10589,0,10589,False,True
donato,10542,10542,0,True,False
giovanna,10444,6,10438,False,True
ezio,10426,10426,0,True,False
gianluca,10393,10373,20,True,False
diego,10276,10276,0,True,False
federico,10197,10197,0,True,False
ugo,10174,10174,0,True,False
agostino,10141,10141,0,True,False
ernesto,10059,10059,0,True,False
francesca,9680,0,9680,False,True
simone,9618,9601,17,True,False
danilo,9548,9548,0,True,False
alfonso,9514,9514,0,True,False
felice,9492,9491,1,True,False
graziano,9441,9432,9,True,False
patrizia,9368,0,9368,False,True
sebastiano,9343,9343,0,True,False
valter,9312,9312,0,True,False
fernando,9236,9236,0,True,False
massimiliano,9010,9010,0,True,False
rosario,8987,8987,0,True,False
antonella,8879,5,8874,False,True
corrado,8858,8858,0,True,False
angela,8825,2,8823,False,True
valerio,8665,8665,0,True,False
emanuele,8547,8532,15,True,False
dino,8502,8502,0,True,False
attilio,8342,8337,5,True,False
tommaso,8302,8302,0,True,False
lino,8238,8238,0,True,False
lucio,8105,8105,0,True,False
gianluigi,8105,8105,0,True,False
marino,7954,7954,0,True,False
elena,7951,5,7946,False,True
giuseppina,7867,3,7864,False,True
gerardo,7844,7844,0,True,False
lucia,7775,0,7775,False,True
livio,7759,7759,0,True,False
silvia,7729,1,7728,False,True
romano,7720,7720,0,True,False
italo,7568,7568,0,True,False
cosimo,7458,7458,0,True,False
ettore,7297,7291,6,True,False
augusto,7211,7211,0,True,False
carla,7210,0,7210,False,True
remo,7152,7152,0,True,False
ferdinando,7115,7115,0,True,False
stefania,7087,0,7087,False,True
tiziano,6905,6905,0,True,False
cristina,6856,0,6856,False,True
giovannibattista,6748,6748,0,True,False
barbara,6739,0,6739,False,True
ivano,6639,6639,0,True,False
monica,6634,0,6634,False,True
fulvio,6474,6474,0,True,False
mariano,6351,6351,0,True,False
roberta,6296,0,6296,False,True
alessandra,6232,0,6232,False,True
egidio,6207,6202,5,True,False
gennaro,6206,6206,0,True,False
rosa,6079,0,6079,False,True
piergiorgio,6023,6023,0,True,False
gianpaolo,6017,6016,1,True,False
mariagrazia,6010,5,6005,False,True
franca,5906,1,5905,False,True
valentino,5905,5905,0,True,False
biagio,5895,5895,0,True,False
dante,5875,5875,0,True,False
rita,5778,11,5767,False,True
ivo,5684,5679,5,True,False
pierangelo,5579,5578,1,True,False
saverio,5532,5528,4,True,False
giampiero,5505,5505,0,True,False
claudia,5501,1,5500,False,True
mariateresa,5478,0,5478,False,True
ermanno,5286,5286,0,True,False
edoardo,5282,5282,0,True,False
marina,5194,0,5194,False,True
luigino,5189,5189,0,True,False
ferruccio,5184,5179,5,True,False
ignazio,5165,5165,0,True,False
gabriella,5148,0,5148,False,True
osvaldo,5136,5136,0,True,False
pierino,5130,5130,0,True,False
josef,5109,5109,0,True,False
ivan,5050,5050,0,True,False
rino,5044,5044,0,True,False
tiziana,4990,1,4989,False,True
aurelio,4990,4990,0,True,False
alessio,4950,4950,0,True,False
caterina,4919,0,4919,False,True
fiorenzo,4866,4866,0,True,False
natale,4858,4858,0,True,False
ennio,4855,4855,0,True,False
santo,4831,4831,0,True,False
giampaolo,4669,4669,0,True,False
arturo,4608,4608,0,True,False
calogero,4597,4592,5,True,False
rodolfo,4578,4578,0,True,False
gianpiero,4571,4567,4,True,False
silvana,4541,0,4541,False,True
chiara,4532,0,4532,False,True
loris,4427,4376,51,True,False
antonello,4408,4408,0,True,False
simona,4403,0,4403,False,True
nadia,4401,0,4401,False,True
costantino,4319,4314,5,True,False
elisabetta,4316,0,4316,False,True
rosanna,4312,0,4312,False,True
cinzia,4312,0,4312,False,True
alfio,4281,4281,0,True,False
marialuisa,4272,1,4271,False,True
rinaldo,4263,4263,0,True,False
moreno,4239,4239,0,True,False
amedeo,4179,4179,0,True,False
elisa,4158,0,4158,False,True
achille,4083,4083,0,True,False
gianpietro,4081,4081,0,True,False
gilberto,4070,4070,0,True,False
luciana,3950,0,3950,False,True
teresa,3949,0,3949,False,True
camillo,3898,3895,3,True,False
michela,3876,1,3875,False,True
giuliana,3865,0,3865,False,True
germano,3853,3853,0,True,False
luisa,3838,10,3828,False,True
sara,3833,0,3833,False,True
guglielmo,3776,3776,0,True,False
martino,3722,3722,0,True,False
emanuela,3669,0,3669,False,True
damiano,3655,3655,0,True,False
marisa,3647,0,3647,False,True
ciro,3644,3644,0,True,False
ruggero,3592,3592,0,True,False
orazio,3574,3574,0,True,False
severino,3559,3555,4,True,False
manuela,3558,16,3542,False,True
tullio,3540,3540,0,True,False
oscar,3525,3525,0,True,False
margherita,3496,0,3496,False,True
benedetto,3464,3464,0,True,False
oreste,3448,3443,5,True,False
mirco,3370,3370,0,True,False
bartolomeo,3368,3363,5,True,False
donatella,3365,0,3365,False,True
albino,3308,3308,0,True,False
pierpaolo,3297,3297,0,True,False
giordano,3279,3279,0,True,False
graziella,3273,17,3256,False,True
arnaldo,3260,3255,5,True,False
antonietta,3246,0,3246,False,True
benito,3180,3176,4,True,False
sabrina,3170,0,3170,False,True
loredana,3169,0,3169,False,True
battista,3169,3169,0,True,False
nunzio,3139,3139,0,True,False
patrizio,3125,3125,0,True,False
romeo,3098,3098,0,True,False
adolfo,3083,3083,0,True,False
johann,3079,3079,0,True,False
sandra,3034,0,3034,False,True
cristian,3030,3030,0,True,False
carmela,3029,0,3029,False,True
gianmario,2996,2991,5,True,False
sonia,2993,0,2993,False,True
cristiano,2966,2966,0,True,False
federica,2952,0,2952,False,True
michelangelo,2949,2944,5,True,False
pasqualino,2930,2930,0,True,False
mariacristina,2926,0,2926,False,True
tonino,2911,2911,0,True,False
valentina,2909,0,2909,False,True
valeria,2908,0,2908,False,True
ilario,2907,2907,0,True,False
ottavio,2874,2874,0,True,False
raffaella,2854,1,2853,False,True
mirko,2837,2837,0,True,False
primo,2819,2819,0,True,False
adriana,2801,0,2801,False,True
mariarosa,2797,10,2787,False,True
erminio,2789,2789,0,True,False
serafino,2782,2782,0,True,False
ornella,2770,0,2770,False,True
orlando,2768,2768,0,True,False
sante,2763,2763,0,True,False
emiliano,2718,2718,0,True,False
virgilio,2699,2699,0,True,False
aniello,2695,2695,0,True,False
nazzareno,2666,2660,6,True,False
celestino,2664,2664,0,True,False
franz,2644,2644,0,True,False
tarcisio,2581,2580,1,True,False
nello,2551,2551,0,True,False
mara,2549,8,2541,False,True
giampietro,2547,2547,0,True,False
annalisa,2541,0,2541,False,True
bruna,2538,0,2538,False,True
nicolino,2533,2533,0,True,False
bernardo,2522,2520,2,True,False
gregorio,2487,2487,0,True,False
beniamino,2482,2482,0,True,False
nicoletta,2481,15,2466,False,True
piera,2477,10,2467,False,True
fortunato,2469,2468,1,True,False
rolando,2465,2465,0,True,False
christian,2439,2424,15,True,False
sauro,2404,2404,0,True,False
gioacchino,2397,2397,0,True,False
raimondo,2388,2388,0,True,False
giulia,2379,19,2360,False,True
renata,2377,3,2374,False,True
nicolo',2365,2359,6,True,False
ambrogio,2343,2343,0,True,False
marta,2323,9,2314,False,True
enrica,2313,1,2312,False,True
ivana,2311,8,2303,False,True
giacinto,2255,2250,5,True,False
mariaantonietta,2247,10,2237,False,True
giovanniantonio,2245,2245,0,True,False
virginio,2227,2227,0,True,False
ercole,2201,2201,0,True,False
bernardino,2197,2197,0,True,False
pio,2185,2185,0,True,False
girolamo,2167,2167,0,True,False
giambattista,2157,2153,4,True,False
arcangelo,2117,2117,0,True,False
mirella,2097,0,2097,False,True
nino,2094,2089,5,True,False
ubaldo,2094,2094,0,True,False
alois,2084,2084,0,True,False
santino,2083,2083,0,True,False
eleonora,2059,0,2059,False,True
clemente,2040,2030,10,True,False
giuseppeantonio,2008,2008,0,True,False
grazia,2002,19,1983,False,True
simonetta,1991,8,1983,False,True
natalino,1986,1986,0,True,False
antonia,1960,5,1955,False,True
filomena,1955,0,1955,False,True
gianbattista,1934,1932,2,True,False
alvaro,1911,1911,0,True,False
karl,1903,1903,0,True,False
rossano,1893,1892,1,True,False
rosaria,1868,0,1868,False,True
anselmo,1866,1866,0,True,False
ilaria,1853,8,1845,False,True
liliana,1849,13,1836,False,True
piergiuseppe,1842,1842,0,True,False
elvio,1834,1834,0,True,False
mariapia,1832,0,1832,False,True
mattia,1829,1808,21,True,False
lorena,1815,6,1809,False,True
paolino,1813,1813,0,True,False
leo,1811,1811,0,True,False
marilena,1784,0,1784,False,True
concetta,1782,0,1782,False,True
gaspare,1779,1779,0,True,False
vittorino,1753,1753,0,True,False
isabella,1746,4,1742,False,True
domenica,1738,0,1738,False,True
milena,1731,0,1731,False,True
romolo,1714,1714,0,True,False
lidia,1710,5,1705,False,True
mariangela,1693,13,1680,False,True
piercarlo,1693,1693,0,True,False
annibale,1681,1676,5,True,False
maura,1677,0,1677,False,True
secondo,1645,1645,0,True,False
alessia,1638,0,1638,False,True
peter,1638,1638,0,True,False
david,1634,1634,0,True,False
maddalena,1617,11,1606,False,True
emidio,1616,1616,0,True,False
leopoldo,1616,1616,0,True,False
pierantonio,1578,1578,0,True,False
denis,1568,1525,43,True,False
susanna,1558,0,1558,False,True
clara,1548,1,1547,False,True
teresio,1547,1547,0,True,False
manuel,1537,1537,0,True,False
lodovico,1533,1533,0,True,False
loretta,1526,10,1516,False,True
mariarosaria,1515,0,1515,False,True
giovannimaria,1506,1500,6,True,False
carmen,1499,46,1453,False,True
silvestro,1493,1493,0,True,False
lamberto,1485,1485,0,True,False
teodoro,1485,1485,0,True,False
irene,1484,11,1473,False,True
guerrino,1480,1480,0,True,False
serena,1472,0,1472,False,True
giuseppa,1444,0,1444,False,True
rossella,1443,0,1443,False,True
emilia,1425,0,1425,False,True
samuele,1422,1422,0,True,False
mariaangela,1418,4,1414,False,True
francescopaolo,1418,1418,0,True,False
gavino,1416,1416,0,True,False
isidoro,1403,1403,0,True,False
katia,1399,8,1391,False,True
anton,1391,1391,0,True,False
fiorella,1384,5,1379,False,True
marinella,1382,5,1377,False,True
mariarita,1380,0,1380,False,True
doriano,1379,1379,0,True,False
francescoantonio,1376,1376,0,True,False
basilio,1370,1370,0,True,False
ottorino,1368,1368,0,True,False
leandro,1364,1364,0,True,False
adelio,1356,1356,0,True,False
duilio,1356,1356,0,True,False
annarita,1354,0,1354,False,True
gianmarco,1352,1352,0,True,False
eligio,1342,1342,0,True,False
thomas,1342,1342,0,True,False
marzia,1341,0,1341,False,True
cataldo,1340,1340,0,True,False
marcella,1339,12,1327,False,True
onofrio,1337,1337,0,True,False
giacomino,1333,1333,0,True,False
remigio,1332,1332,0,True,False
michelino,1330,1330,0,True,False
gianantonio,1328,1328,0,True,False
mariella,1323,0,1323,False,True
vincenza,1310,0,1310,False,True
mariagiovanna,1308,5,1303,False,True
pierfranco,1303,1303,0,True,False
angiolino,1302,1302,0,True,False
raffaello,1301,1301,0,True,False
vinicio,1299,1299,0,True,False
rossana,1296,0,1296,False,True
martina,1294,0,1294,False,True
rosalba,1293,0,1293,False,True
pietropaolo,1291,1291,0,True,False
arrigo,1287,1287,0,True,False
oliviero,1284,1284,0,True,False
gualtiero,1283,1283,0,True,False
vanni,1282,1278,4,True,False
marzio,1282,1282,0,True,False
giuseppino,1261,1261,0,True,False
rosella,1261,5,1256,False,True
marianna,1247,5,1242,False,True
lorella,1242,4,1238,False,True
luigia,1241,10,1231,False,True
efisio,1239,1239,0,True,False
giandomenico,1236,1231,5,True,False
lorenza,1235,21,1214,False,True
eraldo,1227,1227,0,True,False
gianna,1227,9,1218,False,True
lara,1220,7,1213,False,True
agnese,1214,15,1199,False,True
fabiano,1210,1209,1,True,False
igino,1203,1203,0,True,False
ida,1201,9,1192,False,True
ermes,1200,1200,0,True,False
beatrice,1199,9,1190,False,True
omar,1187,1187,0,True,False
manlio,1178,1178,0,True,False
tito,1172,1172,0,True,False
andreas,1167,1167,0,True,False
lauro,1161,1161,0,True,False
giovannino,1156,1156,0,True,False
martin,1148,1148,0,True,False
ermenegildo,1143,1143,0,True,False
giannino,1141,1141,0,True,False
fedele,1135,1135,0,True,False
libero,1133,1133,0,True,False
paul,1130,1130,0,True,False
flavia,1127,9,1118,False,True
romina,1120,0,1120,False,True
eros,1119,1119,0,True,False
floriano,1109,1109,0,True,False
adamo,1103,1103,0,True,False
sabatino,1102,1102,0,True,False
faustino,1097,1097,0,True,False
luigina,1093,4,1089,False,True
catia,1091,0,1091,False,True
lanfranco,1090,1090,0,True,False
tomaso,1081,1081,0,True,False
lina,1077,5,1072,False,True
adele,1073,0,1073,False,True
peppino,1071,1071,0,True,False
bianca,1065,0,1065,False,True
bortolo,1063,1063,0,True,False
vittoria,1062,5,1057,False,True
pino,1044,1044,0,True,False
valeriano,1043,1043,0,True,False
costanzo,1042,1042,0,True,False
gastone,1030,1030,0,True,False
miriam,1016,31,985,False,True
sabino,1014,1014,0,True,False
giovan,1011,1011,0,True,False
giovanbattista,1011,1011,0,True,False
loreto,1006,1006,0,True,False
gustavo,1004,1004,0,True,False
erika,1004,4,1000,False,True
gerolamo,997,997,0,True,False
leone,994,994,0,True,False
savino,994,994,0,True,False
debora,993,0,993,False,True
assunta,988,0,988,False,True
luisella,985,8,977,False,True
william,984,984,0,True,False
candido,983,983,0,True,False
pellegrino,983,983,0,True,False
eliseo,982,977,5,True,False
ada,981,3,978,False,True
heinrich,980,980,0,True,False
nevio,979,979,0,True,False
igor,973,973,0,True,False
veronica,968,0,968,False,True
carloalberto,961,961,0,True,False
alice,958,20,938,False,True
emma,949,0,949,False,True
innocenzo,944,938,6,True,False
letizia,944,0,944,False,True
quinto,943,943,0,True,False
giustino,936,936,0,True,False
demetrio,933,933,0,True,False
gianmaria,929,909,20,True,False
aristide,928,923,5,True,False
vilma,924,9,915,False,True
hermann,923,923,0,True,False
morena,923,0,923,False,True
edmondo,921,921,0,True,False
arianna,920,9,911,False,True
gloria,919,0,919,False,True
sabina,908,0,908,False,True
eduardo,906,906,0,True,False
mariapaola,904,5,899,False,True
adelmo,898,898,0,True,False
elvira,897,7,890,False,True
rosalia,895,0,895,False,True
enio,888,883,5,True,False
rosamaria,885,0,885,False,True
cristoforo,884,884,0,True,False
antoniogiuseppe,883,883,0,True,False
cesarino,880,880,0,True,False
guerino,874,874,0,True,False
sabato,874,874,0,True,False
robert,864,864,0,True,False
amerigo,864,864,0,True,False
pierina,859,0,859,False,True
piermario,859,859,0,True,False
carolina,857,0,857,False,True
hubert,847,847,0,True,False
vanda,838,0,838,False,True
georg,836,836,0,True,False
erica,834,0,834,False,True
narciso,833,833,0,True,False
pasqualina,831,0,831,False,True
settimio,831,831,0,True,False
giovannipaolo,830,830,0,True,False
cecilia,829,0,829,False,True
oronzo,822,822,0,True,False
ludovico,821,817,4,True,False
palmiro,812,812,0,True,False
antonina,809,0,809,False,True
antimo,808,803,5,True,False
modesto,808,808,0,True,False
domenicoantonio,807,807,0,True,False
angelino,799,799,0,True,False
herbert,793,793,0,True,False
angelina,793,0,793,False,True
lionello,787,787,0,True,False
giovannicarlo,782,777,5,True,False
alex,776,776,0,True,False
virginia,776,8,768,False,True
marcellino,773,773,0,True,False
otello,773,773,0,True,False
paride,771,771,0,True,False
arduino,771,771,0,True,False
orietta,770,4,766,False,True
berardino,768,768,0,True,False
mariagabriella,768,0,768,False,True
fabiola,760,5,755,False,True
maurilio,757,757,0,True,False
markus,757,757,0,True,False
adalberto,757,757,0,True,False
giovanniluigi,756,756,0,True,False
viviana,752,0,752,False,True
giovannimario,749,749,0,True,False
filiberto,749,749,0,True,False
goffredo,748,748,0,True,False
vasco,747,747,0,True,False
nando,746,746,0,True,False
pietroantonio,744,744,0,True,False
antoniomaria,742,737,5,True,False
leonello,742,742,0,True,False
donata,740,17,723,False,True
cosmo,738,738,0,True,False
vitoantonio,733,733,0,True,False
alba,731,5,726,False,True
siro,730,730,0,True,False
giorgia,729,5,724,False,True
monia,725,0,725,False,True
pompeo,724,724,0,True,False
mariamaddalena,724,3,721,False,True
erasmo,722,722,0,True,False
gaudenzio,718,718,0,True,False
americo,717,717,0,True,False
giosue',715,715,0,True,False
germana,709,2,707,False,True
romualdo,706,706,0,True,False
santi,701,701,0,True,False
albert,700,700,0,True,False
generoso,699,699,0,True,False
fernanda,695,0,695,False,True
cornelio,695,695,0,True,False
rosetta,694,0,694,False,True
carletto,691,691,0,True,False
costante,690,690,0,True,False
rudi,690,690,0,True,False
elsa,689,0,689,False,True
ciriaco,688,688,0,True,False
angelomaria,688,677,11,True,False
mariaconcetta,685,5,680,False,True
terenzio,684,684,0,True,False
anita,682,0,682,False,True
giovannipietro,678,678,0,True,False
ester,676,29,647,False,True
richard,675,675,0,True,False
linda,674,0,674,False,True
nereo,673,673,0,True,False
ines,672,17,655,False,True
vladimiro,670,670,0,True,False
amilcare,670,670,0,True,False
mariaassunta,670,0,670,False,True
quirino,669,669,0,True,False
liborio,667,667,0,True,False
venanzio,667,667,0,True,False
pierfrancesco,666,666,0,True,False
amalia,660,0,660,False,True
michael,658,658,0,True,False
flaviano,658,658,0,True,False
erich,657,657,0,True,False
crescenzo,654,654,0,True,False
silverio,654,654,0,True,False
rosina,654,0,654,False,True
pietroluigi,654,654,0,True,False
daniel,653,653,0,True,False
benvenuto,652,652,0,True,False
andreina,652,3,649,False,True
norberto,651,651,0,True,False
giovambattista,651,651,0,True,False
luana,650,0,650,False,True
oriano,649,649,0,True,False
ulisse,649,649,0,True,False
eva,646,0,646,False,True
gesuino,644,644,0,True,False
michelina,643,0,643,False,True
tiberio,641,641,0,True,False
antonioluigi,635,635,0,True,False
annunziata,628,0,628,False,True
abramo,628,628,0,True,False
werner,627,627,0,True,False
fiorenza,621,0,621,False,True
enea,620,615,5,True,False
cristiana,618,0,618,False,True
tamara,618,7,611,False,True
mariacarla,617,7,610,False,True
geremia,617,617,0,True,False
roland,614,614,0,True,False
florindo,613,613,0,True,False
delio,611,611,0,True,False
mariavittoria,611,0,611,False,True
marioantonio,608,608,0,True,False
elda,607,7,600,False,True
vitantonio,604,604,0,True,False
mariogiuseppe,603,603,0,True,False
edgardo,602,602,0,True,False
serenella,599,0,599,False,True
oriana,598,0,598,False,True
rosolino,597,597,0,True,False
luigiantonio,596,596,0,True,False
eliana,596,5,591,False,True
mariachiara,595,0,595,False,True
stefan,594,594,0,True,False
francescomaria,593,590,3,True,False
ovidio,591,591,0,True,False
liberato,591,591,0,True,False
mariafrancesca,590,0,590,False,True
livia,589,2,587,False,True
alcide,588,588,0,True,False
maurizia,588,4,584,False,True
brunella,587,0,587,False,True
gisella,586,0,586,False,True
angeloantonio,585,585,0,True,False
aurora,582,0,582,False,True
dionigi,580,580,0,True,False
gigliola,579,5,574,False,True
sisto,578,578,0,True,False
fulvia,575,7,568,False,True
vanna,575,0,575,False,True
oswald,571,571,0,True,False
olga,570,0,570,False,True
rudolf,570,570,0,True,False
angeloraffaele,568,568,0,True,False
orfeo,568,568,0,True,False
vincenzino,562,562,0,True,False
manfred,560,560,0,True,False
celso,560,560,0,True,False
andreino,560,560,0,True,False
giovannifrancesco,558,557,1,True,False
helmut,557,557,0,True,False
anacleto,557,557,0,True,False
angelamaria,556,0,556,False,True
pierangela,554,14,540,False,True
marialaura,552,0,552,False,True
mariacarmela,552,5,547,False,True
prospero,552,552,0,True,False
giusto,551,551,0,True,False
santina,550,0,550,False,True
annarosa,550,0,550,False,True
gildo,548,548,0,True,False
tania,545,6,539,False,True
mariaelena,542,4,538,False,True
annunziato,541,541,0,True,False
cosimodamiano,539,539,0,True,False
dionisio,538,538,0,True,False
giancarla,538,5,533,False,True
marialucia,538,0,538,False,True
piergiovanni,538,538,0,True,False
francescogiuseppe,535,535,0,True,False
francescosaverio,535,535,0,True,False
beppino,534,534,0,True,False
evaristo,531,531,0,True,False
alfred,531,531,0,True,False
giovannigiuseppe,528,528,0,True,False
irma,527,4,523,False,True
giuseppeluigi,527,527,0,True,False
rosangela,526,5,521,False,True
pantaleo,524,524,0,True,False
micheleantonio,523,523,0,True,False
camilla,523,0,523,False,True
flora,523,9,514,False,True
pancrazio,522,522,0,True,False
olindo,517,517,0,True,False
salvatoreantonio,516,516,0,True,False
ulderico,516,516,0,True,False
immacolata,516,2,514,False,True
antoniomario,515,515,0,True,False
alda,513,2,511,False,True
bartolo,512,512,0,True,False
fiore,512,496,16,True,False
francescantonio,512,512,0,True,False
lido,512,512,0,True,False
canio,510,510,0,True,False
giuseppemario,510,510,0,True,False
albano,509,509,0,True,False
pierdomenico,508,508,0,True,False
erminia,508,15,493,False,True
amos,508,508,0,True,False
agata,507,5,502,False,True
vitale,505,505,0,True,False
matilde,505,9,496,False,True
vitaliano,504,504,0,True,False
alida,502,0,502,False,True
concetto,502,502,0,True,False
antoniosalvatore,498,498,0,True,False
teresina,498,0,498,False,True
vittore,496,496,0,True,False
jacopo,494,494,0,True,False
licia,493,5,488,False,True
carmelina,492,0,492,False,True
omero,492,492,0,True,False
onorato,492,492,0,True,False
norbert,489,489,0,True,False
iolanda,488,0,488,False,True
dina,488,0,488,False,True
nazario,483,483,0,True,False
placido,481,481,0,True,False
konrad,480,480,0,True,False
antoniogiovanni,480,480,0,True,False
diana,480,10,470,False,True
ernestino,479,479,0,True,False
nazareno,479,479,0,True,False
romana,479,0,479,False,True
gioachino,479,479,0,True,False
manuele,479,474,5,True,False
gunther,478,478,0,True,False
antioco,478,478,0,True,False
pamela,478,0,478,False,True
eugenia,477,5,472,False,True
vera,477,0,477,False,True
serafina,476,0,476,False,True
olivo,476,476,0,True,False
mariagiuseppina,472,0,472,False,True
clementina,472,2,470,False,True
robertino,471,471,0,True,False
fausta,470,0,470,False,True
aldino,468,468,0,True,False
cesarina,468,0,468,False,True
lisa,468,0,468,False,True
florian,466,466,0,True,False
clelia,465,4,461,False,True
raffaela,464,4,460,False,True
augusta,463,4,459,False,True
ilio,463,463,0,True,False
nella,461,0,461,False,True
pieroluigi,459,459,0,True,False
domenicantonio,458,458,0,True,False
angiolo,458,458,0,True,False
nicodemo,457,457,0,True,False
rina,455,5,450,False,True
ruggiero,453,453,0,True,False
alfiero,452,452,0,True,False
rachele,450,24,426,False,True
fiorentino,449,449,0,True,False
lelio,448,448,0,True,False
gemma,447,5,442,False,True
glauco,446,446,0,True,False
onorio,443,443,0,True,False
mariaantonia,443,8,435,False,True
vincenzina,443,1,442,False,True
marialuigia,443,0,443,False,True
fermo,442,442,0,True,False
gianandrea,442,442,0,True,False
amelio,440,440,0,True,False
danila,439,0,439,False,True
adelino,439,439,0,True,False
deborah,439,0,439,False,True
chiaffredo,438,438,0,True,False
nunziato,438,438,0,True,False
quintino,436,436,0,True,False
pietroangelo,434,434,0,True,False
abele,434,434,0,True,False
siegfried,433,433,0,True,False
fabrizia,433,5,428,False,True
mariastella,433,0,433,False,True
gina,432,0,432,False,True
alberico,431,431,0,True,False
cesidio,430,430,0,True,False
arnold,430,430,0,True,False
giovannifranco,430,425,5,True,False
gottfried,430,430,0,True,False
micaela,429,10,419,False,True
pacifico,428,428,0,True,False
amelia,428,0,428,False,True
vania,425,0,425,False,True
lia,424,0,424,False,True
alan,421,421,0,True,False
agatino,417,417,0,True,False
patrick,417,417,0,True,False
gesualdo,417,417,0,True,False
urbano,417,417,0,True,False
fioravante,417,417,0,True,False
miranda,416,5,411,False,True
francescomario,414,414,0,True,False
ernst,414,414,0,True,False
nerio,413,413,0,True,False
stella,411,0,411,False,True
antoniodomenico,410,410,0,True,False
gianfilippo,410,410,0,True,False
christoph,409,409,0,True,False
tindaro,409,409,0,True,False
fabiana,409,5,404,False,True
massimino,408,408,0,True,False
delia,407,0,407,False,True
pia,407,0,407,False,True
edda,405,8,397,False,True
giacomina,405,0,405,False,True
emiliana,405,0,405,False,True
enza,404,10,394,False,True
benigno,402,402,0,True,False
erwin,401,401,0,True,False
daria,400,5,395,False,True
nico,400,400,0,True,False
floriana,397,5,392,False,True
hans,396,396,0,True,False
celestina,396,2,394,False,True
rosita,396,0,396,False,True
reinhard,395,395,0,True,False
lidio,395,395,0,True,False
eusebio,394,394,0,True,False
iginio,393,393,0,True,False
vanessa,392,0,392,False,True
albertino,391,391,0,True,False
nicolina,389,5,384,False,True
flaminio,389,389,0,True,False
giuseppemaria,388,387,1,True,False
ermano,387,382,5,True,False
dorino,387,387,0,True,False
piergiacomo,387,387,0,True,False
bonaventura,386,386,0,True,False
raul,386,386,0,True,False
melchiorre,385,381,4,True,False
luigimario,384,384,0,True,False
stanislao,384,384,0,True,False
manfredo,383,383,0,True,False
mariaanna,382,0,382,False,True
gio,382,382,0,True,False
giobatta,382,382,0,True,False
cono,382,382,0,True,False
baldassare,381,376,5,True,False
alexander,381,381,0,True,False
ombretta,379,3,376,False,True
galdino,379,379,0,True,False
furio,379,379,0,True,False
antoniofrancesco,378,378,0,True,False
ottaviano,378,378,0,True,False
angelogiuseppe,377,377,0,True,False
sofia,377,0,377,False,True
desiderio,376,376,0,True,False
sebastian,376,376,0,True,False
othmar,375,375,0,True,False
bachisio,372,372,0,True,False
liana,372,5,367,False,True
nicandro,369,369,0,True,False
amleto,369,369,0,True,False
mose',368,368,0,True,False
roccoantonio,368,368,0,True,False
natalina,368,5,363,False,True
eliano,368,368,0,True,False
edo,368,368,0,True,False
giuseppefrancesco,368,368,0,True,False
plinio,366,366,0,True,False
santa,365,5,360,False,True
giovannamaria,364,5,359,False,True
salvatoreangelo,364,364,0,True,False
benedetta,364,5,359,False,True
nunzia,363,5,358,False,True
giuseppedomenico,363,363,0,True,False
alvise,363,360,3,True,False
vigilio,360,360,0,True,False
pietrogiuseppe,360,360,0,True,False
pantaleone,359,359,0,True,False
jessica,358,4,354,False,True
monika,358,0,358,False,True
sandrino,358,358,0,True,False
nives,352,2,350,False,True
ilenia,352,1,351,False,True
delfino,351,351,0,True,False
fiorello,351,351,0,True,False
alma,350,5,345,False,True
gianfranca,350,0,350,False,True
kurt,350,350,0,True,False
nicolaantonio,349,349,0,True,False
evasio,348,348,0,True,False
giuseppegiovanni,348,348,0,True,False
lazzaro,346,346,0,True,False
amato,344,344,0,True,False
wilma,342,5,337,False,True
bernhard,342,342,0,True,False
dimitri,342,342,0,True,False
elso,341,341,0,True,False
gianangelo,341,341,0,True,False
doriana,340,0,340,False,True
pietrogiovanni,340,340,0,True,False
angelantonio,339,339,0,True,False
giuliocesare,338,338,0,True,False
pina,338,4,334,False,True
giovannidomenico,337,337,0,True,False
loriano,337,337,0,True,False
florio,337,337,0,True,False
juri,337,337,0,True,False
vincenzoantonio,336,336,0,True,False
innocente,336,336,0,True,False
mariacaterina,335,0,335,False,True
tino,334,334,0,True,False
adolf,334,334,0,True,False
milva,334,0,334,False,True
natalia,333,4,329,False,True
raniero,333,333,0,True,False
alberta,332,0,332,False,True
tatiana,332,0,332,False,True
lauretta,332,5,327,False,True
nicolo,332,332,0,True,False
corradino,331,331,0,True,False
magda,330,0,330,False,True
luigigiuseppe,330,330,0,True,False
fiorino,328,328,0,True,False
vittoriano,326,326,0,True,False
helmuth,326,326,0,True,False
wanda,326,0,326,False,True
wilhelm,324,324,0,True,False
marialetizia,323,0,323,False,True
denise,323,7,316,False,True
costanza,323,0,323,False,True
elmar,322,322,0,True,False
alfeo,318,318,0,True,False
marioangelo,318,318,0,True,False
nilo,317,317,0,True,False
feliciano,317,317,0,True,False
giovanniandrea,316,316,0,True,False
boris,316,316,0,True,False
severo,316,316,0,True,False
ippazio,314,314,0,True,False
pietrino,314,314,0,True,False
ileana,313,9,304,False,True
silvino,313,313,0,True,False
liviana,312,0,312,False,True
renza,312,0,312,False,True
otto,312,312,0,True,False
giuditta,312,0,312,False,True
settimo,311,311,0,True,False
moira,311,0,311,False,True
giuseppesalvatore,311,311,0,True,False
cipriano,311,311,0,True,False
pietrocarlo,310,310,0,True,False
palmino,309,309,0,True,False
sirio,309,309,0,True,False
epifanio,309,309,0,True,False
fernandoantonio,309,309,0,True,False
samantha,307,0,307,False,True
gianfrancesco,307,307,0,True,False
zeno,306,306,0,True,False
pinuccio,306,306,0,True,False
manolo,305,305,0,True,False
egisto,305,305,0,True,False
bonifacio,304,304,0,True,False
stelio,303,303,0,True,False
mariuccia,302,0,302,False,True
angelica,302,0,302,False,True
paologiuseppe,301,301,0,True,False
marziano,300,300,0,True,False
gennarino,299,299,0,True,False
rudy,299,299,0,True,False
giovanniangelo,298,298,0,True,False
marcoantonio,298,298,0,True,False
delfina,298,0,298,False,True
gianvittorio,298,298,0,True,False
albertina,297,0,297,False,True
antoniomichele,297,297,0,True,False
adelina,296,0,296,False,True
licio,295,295,0,True,False
mariagiuseppa,295,7,288,False,True
norma,295,0,295,False,True
secondino,295,295,0,True,False
max,295,295,0,True,False
antoniopietro,294,294,0,True,False
gilda,294,0,294,False,True
carloantonio,294,294,0,True,False
mariadomenica,292,8,284,False,True
franzjosef,291,291,0,True,False
tranquillo,291,291,0,True,False
giocondo,290,290,0,True,False
marioluigi,290,290,0,True,False
yuri,289,289,0,True,False
antonioangelo,289,289,0,True,False
dora,288,0,288,False,True
klaus,288,288,0,True,False
giovannina,287,4,283,False,True
filomeno,287,284,3,True,False
edilio,285,285,0,True,False
gianmauro,285,285,0,True,False
carluccio,284,284,0,True,False
giuseppantonio,284,284,0,True,False
elisabeth,283,0,283,False,True
errico,283,283,0,True,False
leda,282,0,282,False,True
spartaco,281,281,0,True,False
egle,280,10,270,False,True
paoloantonio,278,278,0,True,False
noemi,277,0,277,False,True
ireneo,276,276,0,True,False
erik,276,276,0,True,False
artemio,276,276,0,True,False
gerlando,276,276,0,True,False
ernestina,275,0,275,False,True
mariagiulia,274,0,274,False,True
carlogiuseppe,274,274,0,True,False
lucilla,274,7,267,False,True
ersilio,273,273,0,True,False
adelchi,273,273,0,True,False
gervasio,273,273,0,True,False
ippolito,272,272,0,True,False
giuseppecarlo,272,272,0,True,False
mimmo,272,272,0,True,False
tobia,271,271,0,True,False
gianmichele,271,271,0,True,False
isaia,270,270,0,True,False
helga,270,0,270,False,True
cirillo,269,269,0,True,False
maggiorino,268,268,0,True,False
modestino,268,268,0,True,False
marica,267,0,267,False,True
angelomichele,267,267,0,True,False
giuseppeangelo,267,267,0,True,False
cleto,266,266,0,True,False
elpidio,266,266,0,True,False
vilmo,266,266,0,True,False
wolfgang,265,265,0,True,False
giannantonio,264,264,0,True,False
elide,263,5,258,False,True
imerio,263,263,0,True,False
francescogiovanni,263,263,0,True,False
piergianni,263,263,0,True,False
erio,263,263,0,True,False
carlomaria,263,255,8,True,False
palmerino,263,263,0,True,False
casimiro,262,262,0,True,False
biancamaria,261,0,261,False,True
genesio,261,261,0,True,False
giannina,261,5,256,False,True
ivonne,260,9,251,False,True
samanta,260,5,255,False,True
salvatoregiuseppe,259,259,0,True,False
carmineantonio,259,259,0,True,False
robertogiuseppe,259,259,0,True,False
aurelia,258,0,258,False,True
michelearcangelo,258,258,0,True,False
mariaelisa,258,3,255,False,True
marcogiuseppe,258,258,0,True,False
ermete,258,258,0,True,False
giannicola,257,257,0,True,False
mariogiovanni,256,256,0,True,False
vittorina,255,5,250,False,True
evelina,255,5,250,False,True
moris,255,255,0,True,False
clotilde,255,5,250,False,True
nedo,255,255,0,True,False
ernesta,254,0,254,False,True
giada,254,7,247,False,True
nerina,253,5,248,False,True
mariofrancesco,252,252,0,True,False
luigigiovanni,252,252,0,True,False
firmino,252,252,0,True,False
paolomaria,252,247,5,True,False
brunello,252,252,0,True,False
albina,251,3,248,False,True
eduard,250,250,0,True,False
gelindo,250,250,0,True,False
pieraldo,250,250,0,True,False
concettina,250,0,250,False,True
sebastiana,249,4,245,False,True
rosaanna,248,0,248,False,True
sesto,245,245,0,True,False
donatello,245,245,0,True,False
pompilio,244,244,0,True,False
micheleangelo,244,244,0,True,False
armin,243,243,0,True,False
lilia,243,0,243,False,True
manola,243,5,238,False,True
angelofrancesco,243,243,0,True,False
pierluca,242,242,0,True,False
efrem,242,242,0,True,False
giulietta,241,5,236,False,True
uberto,241,241,0,True,False
pieroantonio,241,241,0,True,False
pieroangelo,238,238,0,True,False
savina,238,0,238,False,True
athos,237,237,0,True,False
roccogiuseppe,236,236,0,True,False
pierandrea,236,236,0,True,False
marika,236,0,236,False,True
pieralberto,235,235,0,True,False
vita,235,0,235,False,True
francoantonio,233,233,0,True,False
berardo,232,232,0,True,False
eddi,232,217,15,True,False
robertoantonio,232,232,0,True,False
albin,231,231,0,True,False
maristella,230,0,230,False,True
tonio,229,229,0,True,False
loreno,229,229,0,True,False
antoniovincenzo,229,229,0,True,False
angelomario,229,229,0,True,False
annapaola,228,0,228,False,True
pietromario,228,228,0,True,False
oskar,228,228,0,True,False
graziana,227,0,227,False,True
francogiuseppe,227,227,0,True,False
christine,226,0,226,False,True
devis,226,224,2,True,False
luigimaria,224,217,7,True,False
pietrofrancesco,224,224,0,True,False
amadio,224,224,0,True,False
cirino,223,223,0,True,False
leonida,223,213,10,True,False
vitonicola,222,222,0,True,False
piersandro,222,222,0,True,False
luis,221,221,0,True,False
pinuccia,221,0,221,False,True
ivaldo,221,221,0,True,False
jean,220,220,0,True,False
hansjorg,220,220,0,True,False
evandro,220,220,0,True,False
giangiacomo,220,220,0,True,False
regina,219,0,219,False,True
angiolina,219,0,219,False,True
pietrogiorgio,219,219,0,True,False
clementino,219,219,0,True,False
brunoantonio,219,219,0,True,False
eustachio,219,219,0,True,False
pietrina,218,0,218,False,True
fiorindo,218,218,0,True,False
iole,217,0,217,False,True
salvatorangelo,217,217,0,True,False
gianlorenzo,217,217,0,True,False
mariodomenico,217,217,0,True,False
gelsomino,216,216,0,True,False
emanuel,216,216,0,True,False
francescosalvatore,215,215,0,True,False
galliano,215,215,0,True,False
pieropaolo,214,214,0,True,False
manfredi,214,214,0,True,False
angiola,214,2,212,False,True
angelogiovanni,213,213,0,True,False
zefferino,212,212,0,True,False
giuseppenicola,212,212,0,True,False
aureliano,212,212,0,True,False
arsenio,212,212,0,True,False
meri,212,5,207,False,True
waltraud,211,0,211,False,True
giuseppepaolo,210,210,0,True,False
palmerio,209,209,0,True,False
enricomaria,209,206,3,True,False
pierogiuseppe,209,209,0,True,False
aleandro,207,207,0,True,False
gabriela,206,0,206,False,True
felicia,206,5,201,False,True
lucrezia,206,0,206,False,True
stefanino,205,205,0,True,False
marcomaria,205,195,10,True,False
iris,205,5,200,False,True
baldassarre,205,205,0,True,False
stelvio,205,205,0,True,False
fortunata,205,0,205,False,True
agostina,204,0,204,False,True
carlogiovanni,204,204,0,True,False
cesario,204,204,0,True,False
lea,204,4,200,False,True
gianguido,204,204,0,True,False
espedito,203,203,0,True,False
letterio,203,203,0,True,False
pasqualeantonio,203,203,0,True,False
aquilino,203,203,0,True,False
lando,203,203,0,True,False
mariafranca,203,0,203,False,True
olimpio,203,203,0,True,False
giammario,203,203,0,True,False
loreta,203,3,200,False,True
paolina,203,0,203,False,True
miro,203,203,0,True,False
onelio,203,203,0,True,False
gabrio,202,202,0,True,False
onorino,201,201,0,True,False
rosalinda,201,0,201,False,True
quirico,201,201,0,True,False
nicolangelo,200,200,0,True,False
ranieri,200,200,0,True,False
nunziante,200,200,0,True,False
gandolfo,200,197,3,True,False
terzo,199,199,0,True,False
avio,199,199,0,True,False
giglio,199,199,0,True,False
consuelo,198,17,181,False,True
zaccaria,198,198,0,True,False
giuseppepietro,197,197,0,True,False
elvezio,197,197,0,True,False
elmo,197,197,0,True,False
attilia,197,0,197,False,True
loredano,196,196,0,True,False
luigipietro,196,196,0,True,False
carola,196,0,196,False,True
sestilio,195,195,0,True,False
egon,194,194,0,True,False
palmira,193,5,188,False,True
savio,193,193,0,True,False
velia,193,0,193,False,True
pietromaria,193,193,0,True,False
dalmazio,193,193,0,True,False
angeloluigi,192,192,0,True,False
franceschino,192,192,0,True,False
harald,192,192,0,True,False
gherardo,191,191,0,True,False
mariaausilia,191,0,191,False,True
mansueto,190,190,0,True,False
orsola,190,0,190,False,True
donatoantonio,190,190,0,True,False
nunziata,190,0,190,False,True
mariaelisabetta,190,0,190,False,True
gianclaudio,190,190,0,True,False
palma,189,0,189,False,True
ambra,188,0,188,False,True
francamaria,188,1,187,False,True
giovannistefano,188,188,0,True,False
raoul,188,188,0,True,False
feliceantonio,188,188,0,True,False
nadio,187,187,0,True,False
edith,187,0,187,False,True
hartmann,186,186,0,True,False
carloluigi,185,185,0,True,False
robertoangelo,185,185,0,True,False
johanna,184,0,184,False,True
mariaantonella,184,0,184,False,True
carmelino,184,184,0,True,False
paolofrancesco,183,183,0,True,False
lorenzino,183,183,0,True,False
mariaclara,183,5,178,False,True
ido,183,183,0,True,False
ersilia,183,0,183,False,True
gionata,183,183,0,True,False
mariacecilia,182,0,182,False,True
mirna,182,0,182,False,True
meinhard,181,181,0,True,False
matthias,181,181,0,True,False
reinhold,180,180,0,True,False
marcogiovanni,180,180,0,True,False
jakob,180,180,0,True,False
piergiulio,180,180,0,True,False
pierocarlo,179,179,0,True,False
mariocarlo,179,179,0,True,False
friedrich,179,179,0,True,False
catello,179,179,0,True,False
verena,178,0,178,False,True
carlotta,178,0,178,False,True
adelaide,178,0,178,False,True
giorgiomario,178,178,0,True,False
mariosalvatore,177,177,0,True,False
pierlorenzo,177,177,0,True,False
dennis,176,176,0,True,False
ebe,175,0,175,False,True
carmelogiuseppe,175,175,0,True,False
candida,175,0,175,False,True
melissa,175,0,175,False,True
giacinta,174,0,174,False,True
concezio,174,174,0,True,False
milo,174,174,0,True,False
gabriello,174,174,0,True,False
venanzo,174,174,0,True,False
dolores,174,0,174,False,True
giovannibat,173,168,5,True,False
paolamaria,173,0,173,False,True
alceo,173,173,0,True,False
carlamaria,173,0,173,False,True
emiddio,172,172,0,True,False
roccodomenico,172,172,0,True,False
giovannimichele,172,172,0,True,False
archimede,171,171,0,True,False
isacco,171,171,0,True,False
horst,171,171,0,True,False
marcantonio,170,169,1,True,False
lisetta,170,0,170,False,True
gaetana,170,0,170,False,True
lorenz,169,169,0,True,False
nicolamaria,169,159,10,True,False
battistino,168,168,0,True,False
nerino,168,168,0,True,False
cristofaro,168,168,0,True,False
annateresa,168,0,168,False,True
angelopietro,168,168,0,True,False
edmund,167,167,0,True,False
colombo,167,167,0,True,False
ingrid,167,10,157,False,True
giovannipiero,167,167,0,True,False
nikolaus,167,167,0,True,False
andreagiuseppe,166,166,0,True,False
niccolo',166,166,0,True,False
afro,166,166,0,True,False
cosetta,166,0,166,False,True
euro,166,166,0,True,False
petra,165,0,165,False,True
enrichetta,164,0,164,False,True
napoleone,164,164,0,True,False
argentino,164,164,0,True,False
mariaadele,164,0,164,False,True
michel,163,163,0,True,False
amodio,163,163,0,True,False
roman,163,163,0,True,False
ferdinand,163,163,0,True,False
antonioraffaele,163,163,0,True,False
roccoluigi,162,162,0,True,False
valdo,162,162,0,True,False
calogera,162,3,159,False,True
fosco,162,162,0,True,False
melania,162,0,162,False,True
lauramaria,162,0,162,False,True
giulietto,161,161,0,True,False
sanzio,161,161,0,True,False
gianfausto,161,161,0,True,False
felicita,161,0,161,False,True
valentin,161,158,3,True,False
mirta,160,0,160,False,True
hugo,160,160,0,True,False
antoniorocco,160,160,0,True,False
liliano,160,160,0,True,False
alfons,160,160,0,True,False
emo,160,160,0,True,False
roccosalvatore,160,160,0,True,False
mariamargherita,160,0,160,False,True
mirca,159,0,159,False,True
gentile,159,149,10,True,False
paololuigi,159,159,0,True,False
francoluigi,159,159,0,True,False
giangiuseppe,159,159,0,True,False
mariorocco,159,159,0,True,False
antoninogiuseppe,159,155,4,True,False
mariantonietta,159,0,159,False,True
domenicogiuseppe,158,158,0,True,False
olivio,158,158,0,True,False
luigifrancesco,158,158,0,True,False
ulrich,158,158,0,True,False
aida,158,0,158,False,True
enore,158,158,0,True,False
piermarco,158,158,0,True,False
guglielmina,158,0,158,False,True
gonario,157,157,0,True,False
mariaimmacolata,157,0,157,False,True
greta,157,0,157,False,True
luigicarlo,157,157,0,True,False
salvatorica,156,0,156,False,True
ottavia,156,0,156,False,True
sossio,156,156,0,True,False
luigisalvatore,156,156,0,True,False
ramona,156,0,156,False,True
tommasino,156,156,0,True,False
viviano,155,155,0,True,False
angelodomenico,155,155,0,True,False
alido,154,154,0,True,False
miria,154,0,154,False,True
simeone,153,153,0,True,False
sisinnio,153,153,0,True,False
salvatorefrancesco,153,153,0,True,False
gian,153,0,153,False,True
giovannisalvatore,153,153,0,True,False
graziamaria,153,0,153,False,True
leonardoantonio,153,153,0,True,False
marsilio,153,153,0,True,False
cosima,153,0,153,False,True
auro,153,153,0,True,False
sergioantonio,152,152,0,True,False
italia,152,0,152,False,True
gianvito,152,152,0,True,False
hanspeter,152,152,0,True,False
annalucia,151,0,151,False,True
elia,151,151,0,True,False
umile,151,151,0,True,False
iacopo,151,151,0,True,False
ilvo,151,151,0,True,False
erino,151,151,0,True,False
isa,151,3,148,False,True
mariabeatrice,150,0,150,False,True
annita,150,10,140,False,True
manrico,150,150,0,True,False
mauroantonio,150,150,0,True,False
francescamaria,150,0,150,False,True
annunzio,150,150,0,True,False
aleardo,150,150,0,True,False
riziero,149,149,0,True,False
teodosio,149,149,0,True,False
giovannilorenzo,149,149,0,True,False
brunetto,149,149,0,True,False
domenicogiovanni,149,149,0,True,False
mariangelo,149,149,0,True,False
michelegiuseppe,149,149,0,True,False
sergiomario,149,149,0,True,False
gianstefano,148,148,0,True,False
pierugo,148,148,0,True,False
vezio,148,148,0,True,False
addolorata,148,0,148,False,True
tony,148,148,0,True,False
francescodomenico,148,148,0,True,False
elviro,148,148,0,True,False
costantina,147,0,147,False,True
adalgisa,147,0,147,False,True
giammaria,147,142,5,True,False
aladino,147,147,0,True,False
ginetto,147,147,0,True,False
elvino,147,147,0,True,False
ermelinda,146,0,146,False,True
brigida,146,0,146,False,True
velio,146,146,0,True,False
paologiovanni,146,146,0,True,False
alfonsino,146,146,0,True,False
lindo,146,146,0,True,False
armanda,145,0,145,False,True
giustina,145,0,145,False,True
joseph,145,145,0,True,False
sereno,145,145,0,True,False
leonzio,144,144,0,True,False
paolopietro,144,144,0,True,False
giannetto,144,144,0,True,False
elenamaria,144,5,139,False,True
giliola,144,0,144,False,True
aroldo,143,143,0,True,False
nicla,143,0,143,False,True
stefanoantonio,143,140,3,True,False
tina,143,0,143,False,True
pietrodomenico,143,143,0,True,False
mariagraziella,143,0,143,False,True
enzio,143,143,0,True,False
silva,143,0,143,False,True
ruben,143,143,0,True,False
enricomario,143,143,0,True,False
marilisa,142,0,142,False,True
armido,142,142,0,True,False
panfilo,142,142,0,True,False
angelosalvatore,142,142,0,True,False
luigiangelo,142,142,0,True,False
mariopietro,142,142,0,True,False
vincenzomario,141,141,0,True,False
decio,141,141,0,True,False
imelda,141,0,141,False,True
tancredi,141,141,0,True,False
quintilio,141,141,0,True,False
maffeo,141,141,0,True,False
eleuterio,140,140,0,True,False
mila,140,5,135,False,True
domenicofrancesco,140,140,0,True,False
brigitte,139,0,139,False,True
natascia,139,2,137,False,True
carlofrancesco,139,139,0,True,False
olinto,139,139,0,True,False
ewald,139,139,0,True,False
mariabonaria,139,0,139,False,True
teresamaria,139,0,139,False,True
cateno,138,138,0,True,False
antoniopasquale,138,138,0,True,False
fidenzio,138,138,0,True,False
toni,137,137,0,True,False
ildo,137,137,0,True,False
adone,137,137,0,True,False
ludwig,137,137,0,True,False
nelso,136,136,0,True,False
felicino,136,136,0,True,False
hannes,136,136,0,True,False
giovanniluca,136,136,0,True,False
alfonsina,136,0,136,False,True
tammaro,136,136,0,True,False
salvo,136,136,0,True,False
pieromario,136,136,0,True,False
loriana,136,9,127,False,True
gianfelice,136,136,0,True,False
gianmatteo,135,135,0,True,False
ermelindo,135,135,0,True,False
giusepperosario,135,135,0,True,False
grazio,135,135,0,True,False
vittorioangelo,135,135,0,True,False
giordana,135,0,135,False,True
christof,135,135,0,True,False
primiano,135,135,0,True,False
mirto,135,135,0,True,False
helene,135,0,135,False,True
katiuscia,134,5,129,False,True
demis,134,134,0,True,False
pieroandrea,134,134,0,True,False
onorina,134,0,134,False,True
mariapina,134,0,134,False,True
gerhard,134,134,0,True,False
g,133,133,0,True,False
irio,133,133,0,True,False
tecla,133,0,133,False,True
lio,133,133,0,True,False
salvatorevincenzo,133,133,0,True,False
arthur,133,133,0,True,False
gessica,133,8,125,False,True
mariolina,133,10,123,False,True
liviano,132,132,0,True,False
luigipaolo,132,132,0,True,False
gerardino,132,132,0,True,False
eric,132,132,0,True,False
danio,132,132,0,True,False
mafalda,132,0,132,False,True
gianemilio,132,132,0,True,False
giacobbe,131,131,0,True,False
duccio,131,131,0,True,False
spirito,131,131,0,True,False
stefanomaria,131,131,0,True,False
sarah,131,0,131,False,True
biase,131,131,0,True,False
claudino,131,131,0,True,False
vincenzogiuseppe,131,131,0,True,False
ampelio,131,131,0,True,False
isidor,130,130,0,True,False
romildo,130,130,0,True,False
lucagiuseppe,130,130,0,True,False
venturino,130,130,0,True,False
danielegiuseppe,130,130,0,True,False
teobaldo,130,130,0,True,False
ervino,130,130,0,True,False
salvino,130,130,0,True,False
venerando,129,129,0,True,False
claudiogiovanni,129,129,0,True,False
carmelita,129,5,124,False,True
nicolafrancesco,129,129,0,True,False
leonarda,128,3,125,False,True
pierguido,128,128,0,True,False
santolo,128,128,0,True,False
giammarco,128,128,0,True,False
veniero,128,128,0,True,False
brunogiuseppe,128,128,0,True,False
erna,128,0,128,False,True
leucio,128,128,0,True,False
agazio,128,128,0,True,False
simon,127,127,0,True,False
nada,127,0,127,False,True
pasqua,127,0,127,False,True
ermando,127,127,0,True,False
uber,127,127,0,True,False
bernardina,127,5,122,False,True
antenore,127,127,0,True,False
carlino,127,127,0,True,False
jonathan,127,127,0,True,False
croce,127,121,6,True,False
salvatoregiovanni,127,127,0,True,False
crispino,126,126,0,True,False
raimund,126,126,0,True,False
karin,126,5,121,False,True
pierfelice,126,126,0,True,False
piermauro,126,126,0,True,False
raffaeleantonio,126,126,0,True,False
tonina,126,3,123,False,True
paolosalvatore,126,126,0,True,False
atos,125,125,0,True,False
wilmer,125,125,0,True,False
gerardina,125,3,122,False,True
mariadonata,124,0,124,False,True
virna,124,0,124,False,True
salvatrice,124,0,124,False,True
fabiogiuseppe,124,124,0,True,False
brunogiovanni,124,124,0,True,False
ernani,124,124,0,True,False
esterino,123,123,0,True,False
ascanio,123,123,0,True,False
vincenzomaria,123,123,0,True,False
eddo,123,123,0,True,False
giosue,123,123,0,True,False
carlomario,123,123,0,True,False
mariaalessandra,122,0,122,False,True
carloangelo,122,122,0,True,False
giommaria,122,117,5,True,False
mariaenrica,122,0,122,False,True
curzio,122,122,0,True,False
gianenrico,122,122,0,True,False
laila,122,2,120,False,True
biancarosa,122,0,122,False,True
antonionicola,122,122,0,True,False
selene,121,0,121,False,True
samuela,121,0,121,False,True
veronika,121,0,121,False,True
ignazia,121,0,121,False,True
novella,121,0,121,False,True
karlheinz,121,121,0,True,False
filippoantonio,121,121,0,True,False
mariofranco,121,121,0,True,False
mariacarmen,121,0,121,False,True
piercarla,121,0,121,False,True
giomaria,120,120,0,True,False
euplio,120,120,0,True,False
mariovincenzo,120,120,0,True,False
pierre,120,120,0,True,False
ilda,120,0,120,False,True
nicolamario,120,120,0,True,False
celio,120,120,0,True,False
mariovittorio,120,120,0,True,False
wladimiro,120,120,0,True,False
villiam,120,120,0,True,False
lucianoantonio,120,120,0,True,False
delfo,120,120,0,True,False
mariaagnese,120,0,120,False,True
gerarda,120,6,114,False,True
pieraugusto,120,120,0,True,False
nestore,120,120,0,True,False
gustav,119,119,0,True,False
marionicola,119,119,0,True,False
ivone,119,109,10,True,False
pieremilio,119,119,0,True,False
robertomario,119,119,0,True,False
rene',119,119,0,True,False
pieraangela,119,0,119,False,True
enricogiuseppe,119,119,0,True,False
elisio,118,118,0,True,False
francescomichele,118,118,0,True,False
giovannicesare,118,118,0,True,False
gottardo,118,118,0,True,False
bassano,118,118,0,True,False
mariapiera,118,0,118,False,True
giorgina,118,0,118,False,True
willy,118,118,0,True,False
giovanmaria,118,118,0,True,False
rito,118,118,0,True,False
domenicovincenzo,118,118,0,True,False
maurogiuseppe,117,117,0,True,False
orio,117,117,0,True,False
annagrazia,117,0,117,False,True
andreamaria,117,117,0,True,False
costabile,117,117,0,True,False
giuseppemauro,117,117,0,True,False
ermanna,117,0,117,False,True
francodomenico,117,117,0,True,False
dorotea,116,0,116,False,True
giacomogiovanni,116,116,0,True,False
francogiovanni,116,116,0,True,False
nelson,116,116,0,True,False
aimone,116,116,0,True,False
pasqualefrancesco,116,116,0,True,False
piermichele,116,116,0,True,False
claudioantonio,116,116,0,True,False
aldina,115,3,112,False,True
candeloro,115,115,0,True,False
ignaz,115,115,0,True,False
stephan,115,115,0,True,False
mariabruna,115,0,115,False,True
frediano,115,115,0,True,False
andreamario,115,115,0,True,False
vico,115,115,0,True,False
elida,115,0,115,False,True
renate,115,0,115,False,True
anastasio,115,115,0,True,False
battistina,115,0,115,False,True
alceste,114,114,0,True,False
domizio,114,114,0,True,False
mariomichele,114,114,0,True,False
leonilde,114,0,114,False,True
antoniofranco,114,114,0,True,False
annaelisabeth,114,0,114,False,True
giovenale,114,114,0,True,False
saveria,113,0,113,False,True
rosaangela,113,0,113,False,True
filippa,113,0,113,False,True
astrid,113,0,113,False,True
emmanuele,113,113,0,True,False
lavinia,113,0,113,False,True
eliodoro,113,113,0,True,False
filadelfo,113,113,0,True,False
pippo,113,113,0,True,False
catterina,113,0,113,False,True
edvige,112,0,112,False,True
angioletta,112,0,112,False,True
mirio,112,112,0,True,False
mariofelice,112,112,0,True,False
mariadaniela,112,0,112,False,True
iva,112,0,112,False,True
cristino,112,112,0,True,False
milvia,112,0,112,False,True
vincenzosalvatore,112,112,0,True,False
john,112,112,0,True,False
roger,111,111,0,True,False
eriberto,111,111,0,True,False
marcellina,111,0,111,False,True
maurogiovanni,111,106,5,True,False
giuseppeandrea,111,111,0,True,False
gaia,111,0,111,False,True
pasquino,111,111,0,True,False
fulgenzio,111,111,0,True,False
consolato,111,111,0,True,False
felix,111,111,0,True,False
vittorioemanuele,111,111,0,True,False
pietrangelo,111,111,0,True,False
audenzio,110,110,0,True,False
albertomaria,110,106,4,True,False
robertogiovanni,110,110,0,True,False
danillo,110,110,0,True,False
fritz,110,110,0,True,False
mary,110,0,110,False,True
rosmarie,110,0,110,False,True
ildebrando,110,110,0,True,False
dorina,110,0,110,False,True
brunomario,110,110,0,True,False
paoloroberto,109,109,0,True,False
claudiomaria,109,106,3,True,False
pietrovittorio,109,109,0,True,False
ismaele,109,104,5,True,False
heinz,109,109,0,True,False
giorgino,109,109,0,True,False
antoninosalvatore,109,109,0,True,False
mariantonia,109,4,105,False,True
severina,109,0,109,False,True
aniceto,109,109,0,True,False
luigiemilio,109,109,0,True,False
antonioignazio,109,109,0,True,False
nicoladomenico,109,109,0,True,False
consalvo,108,108,0,True,False
wilfried,108,108,0,True,False
annalaura,108,0,108,False,True
berta,108,0,108,False,True
elvis,108,108,0,True,False
innocenza,108,0,108,False,True
gregor,108,108,0,True,False
mino,108,108,0,True,False
giobattista,108,108,0,True,False
reginaldo,108,108,0,True,False
ginetta,108,0,108,False,True
tomas,108,108,0,True,False
rosarita,108,0,108,False,True
carlofelice,107,107,0,True,False
joachim,107,107,0,True,False
albertoluigi,107,107,0,True,False
cesaremaria,107,107,0,True,False
fiorentina,107,0,107,False,True
cosimino,107,107,0,True,False
giusepperocco,106,106,0,True,False
iuri,106,106,0,True,False
almerino,106,106,0,True,False
ermido,106,106,0,True,False
anthony,106,106,0,True,False
idalgo,106,106,0,True,False
pericle,106,106,0,True,False
mauriziogiuseppe,106,106,0,True,False
mariastefania,106,0,106,False,True
serse,106,106,0,True,False
antoniocarlo,106,106,0,True,False
sigfrido,106,106,0,True,False
romilda,105,0,105,False,True
meinrad,105,105,0,True,False
ketty,105,0,105,False,True
luigifranco,105,105,0,True,False
luigibruno,105,105,0,True,False
aldoantonio,105,105,0,True,False
giosafatte,104,104,0,True,False
olimpia,104,0,104,False,True
bonfiglio,103,103,0,True,False
canzio,103,103,0,True,False
nicolas,103,103,0,True,False
aldogiuseppe,103,98,5,True,False
arcangela,103,0,103,False,True
martha,103,0,103,False,True
vitodomenico,103,103,0,True,False
sigismondo,103,103,0,True,False
pieramaria,103,0,103,False,True
anastasia,103,6,97,False,True
pietrantonio,102,102,0,True,False
saturnino,102,102,0,True,False
giusi,102,0,102,False,True
dania,102,0,102,False,True
fiorangelo,102,102,0,True,False
ylenia,102,0,102,False,True
giuseppealberto,102,102,0,True,False
nardo,102,102,0,True,False
decimo,102,102,0,True,False
giuseppevincenzo,102,102,0,True,False
lilliana,102,0,102,False,True
sergiogiuseppe,102,102,0,True,False
gebhard,102,102,0,True,False
francescorocco,102,102,0,True,False
nardino,102,102,0,True,False
mariaaddolorata,101,0,101,False,True
raimonda,101,0,101,False,True
gioconda,101,0,101,False,True
pierpaola,101,0,101,False,True
abbondio,101,101,0,True,False
eolo,101,101,0,True,False
eugenioantonio,101,101,0,True,False
enricoluigi,101,101,0,True,False
giuseppegiacomo,101,101,0,True,False
valente,100,100,0,True,False
italico,100,100,0,True,False
giancarmine,100,100,0,True,False
crescenzio,100,100,0,True,False
massimogiuseppe,100,100,0,True,False
ausilio,100,100,0,True,False
domenicangelo,100,100,0,True,False
esterina,100,0,100,False,True
diodato,100,100,0,True,False
claudiamaria,100,0,100,False,True
sandrina,100,0,100,False,True
alfieri,100,100,0,True,False
odilio,100,100,0,True,False
giuseppinamaria,100,3,97,False,True
marialisa,99,0,99,False,True
morris,99,99,0,True,False
apollonio,99,99,0,True,False
gisberto,99,99,0,True,False
ilde,99,0,99,False,True
brunoenrico,99,99,0,True,False
mariabarbara,99,0,99,False,True
adelia,99,0,99,False,True
zaira,99,4,95,False,True
lucagiovanni,99,99,0,True,False
luigialberto,99,99,0,True,False
andreagiovanni,99,99,0,True,False
pierogiorgio,99,99,0,True,False
amanda,99,1,98,False,True
marcoangelo,98,98,0,True,False
manila,98,0,98,False,True
vincenzogiovanni,98,98,0,True,False
vitogiuseppe,98,98,0,True,False
luciamaria,98,0,98,False,True
ortensio,98,98,0,True,False
bertilla,98,0,98,False,True
cesareaugusto,98,98,0,True,False
mariamichela,98,0,98,False,True
giovannivincenzo,98,98,0,True,False
annaluisa,98,0,98,False,True
giuseppecarmelo,98,98,0,True,False
egildo,97,97,0,True,False
gimmi,97,97,0,True,False
stefanogiovanni,97,97,0,True,False
michelantonio,97,97,0,True,False
luigieugenio,97,97,0,True,False
annunciata,97,0,97,False,True
nicolagiuseppe,97,97,0,True,False
angelita,97,5,92,False,True
torquato,97,97,0,True,False
pietrosalvatore,97,97,0,True,False
vitalino,96,96,0,True,False
palmina,96,0,96,False,True
noe',96,96,0,True,False
evaldo,96,96,0,True,False
milko,96,96,0,True,False
susi,96,0,96,False,True
nazzarena,96,0,96,False,True
priamo,96,96,0,True,False
lorenzomario,96,96,0,True,False
viller,96,96,0,True,False
carmeloantonio,96,96,0,True,False
mariadolores,95,0,95,False,True
lionella,95,0,95,False,True
paula,95,0,95,False,True
salvatoremario,95,95,0,True,False
carloandrea,95,95,0,True,False
giovannib,95,95,0,True,False
elettra,95,0,95,False,True
giamberto,95,95,0,True,False
antoniovito,95,95,0,True,False
marcoluigi,95,95,0,True,False
angelofranco,95,95,0,True,False
evangelista,95,95,0,True,False
mariavincenza,94,0,94,False,True
jenny,94,0,94,False,True
ercolino,94,94,0,True,False
clelio,94,94,0,True,False
mariapatrizia,94,0,94,False,True
marianne,94,0,94,False,True
palmiero,94,94,0,True,False
prisco,94,94,0,True,False
gianvincenzo,94,94,0,True,False
francomario,94,94,0,True,False
antoniolorenzo,94,94,0,True,False
jose',94,94,0,True,False
zaverio,94,94,0,True,False
fosca,94,0,94,False,True
odino,94,94,0,True,False
alessandrogiuseppe,93,93,0,True,False
dilva,93,0,93,False,True
angeloroberto,93,93,0,True,False
olivia,93,0,93,False,True
giorgiogiuseppe,93,93,0,True,False
silviogiuseppe,93,93,0,True,False
marlene,93,0,93,False,True
gualberto,93,93,0,True,False
salvatoremaria,93,93,0,True,False
devid,93,93,0,True,False
filadelfio,93,93,0,True,False
giacomoantonio,93,93,0,True,False
gelmino,93,93,0,True,False
cherubino,93,93,0,True,False
arialdo,93,93,0,True,False
oddone,93,93,0,True,False
rizieri,93,93,0,True,False
andreastefano,93,93,0,True,False
giuseppemichele,92,92,0,True,False
silvestre,92,92,0,True,False
piervittorio,92,92,0,True,False
tersilio,92,92,0,True,False
giuseppeclaudio,92,92,0,True,False
giuseppeluciano,92,92,0,True,False
adorno,92,92,0,True,False
stefanina,92,0,92,False,True
massimomaria,92,92,0,True,False
annachiara,92,0,92,False,True
rosalino,92,92,0,True,False
cesira,92,5,87,False,True
patrik,92,92,0,True,False
vincenzorosario,92,92,0,True,False
samuel,92,92,0,True,False
brigitta,92,0,92,False,True
paoletto,92,92,0,True,False
corinna,92,5,87,False,True
soccorso,91,91,0,True,False
pietrogiulio,91,91,0,True,False
lillo,91,91,0,True,False
teodora,91,5,86,False,True
giacoma,91,0,91,False,True
antonioalfonso,91,91,0,True,False
pietrofranco,91,91,0,True,False
gianfrancogiuseppe,91,91,0,True,False
robertoluigi,91,91,0,True,False
oberdan,91,91,0,True,False
ferdinanda,91,5,86,False,True
leonildo,91,91,0,True,False
alfredoantonio,90,90,0,True,False
endrio,90,90,0,True,False
miriano,90,90,0,True,False
fiorangela,90,0,90,False,True
domingo,90,90,0,True,False
hermannjosef,90,90,0,True,False
dieter,90,90,0,True,False
biagino,90,90,0,True,False
lussorio,90,90,0,True,False
mariopio,90,90,0,True,False
mariopasquale,90,90,0,True,False
annaelisa,90,0,90,False,True
rosildo,90,90,0,True,False
elvi,89,89,0,True,False
aristodemo,89,89,0,True,False
gilio,89,89,0,True,False
francosergio,89,89,0,True,False
giovangiuseppe,89,89,0,True,False
ettorino,89,89,0,True,False
giuseppeemilio,89,89,0,True,False
marioenrico,89,89,0,True,False
filippomaria,89,89,0,True,False
ado,89,89,0,True,False
speranza,89,0,89,False,True
tosca,88,0,88,False,True
ezia,88,0,88,False,True
paolomario,88,88,0,True,False
francescoluigi,88,88,0,True,False
herta,88,0,88,False,True
annino,88,88,0,True,False
oliva,88,0,88,False,True
angelico,88,88,0,True,False
mariaemilia,88,0,88,False,True
mariopaolo,88,88,0,True,False
cornelia,88,0,88,False,True
iseo,88,88,0,True,False
francescocarlo,88,88,0,True,False
adrio,88,88,0,True,False
orazioantonio,88,88,0,True,False
domenicosalvatore,88,88,0,True,False
chiaramaria,88,0,88,False,True
tullia,88,0,88,False,True
deanna,87,0,87,False,True
sisinio,87,87,0,True,False
irmo,87,87,0,True,False
baldo,87,87,0,True,False
enricogiovanni,87,87,0,True,False
arcadio,87,87,0,True,False
rocchino,87,87,0,True,False
emilioantonio,87,87,0,True,False
gabriel,87,87,0,True,False
giovannigiacomo,87,87,0,True,False
aronne,87,87,0,True,False
kristian,87,87,0,True,False
francescoangelo,87,87,0,True,False
nara,87,0,87,False,True
domenicomario,86,86,0,True,False
giovannialberto,86,86,0,True,False
thierry,86,86,0,True,False
alberino,86,86,0,True,False
pietroenrico,86,86,0,True,False
giorgiogiovanni,86,86,0,True,False
luiginicola,86,86,0,True,False
carlopietro,86,86,0,True,False
piervincenzo,86,86,0,True,False
guglielmino,86,86,0,True,False
gelsomina,86,0,86,False,True
giuseppemassimo,86,86,0,True,False
ginoantonio,86,86,0,True,False
mariacarolina,86,0,86,False,True
vitangelo,86,86,0,True,False
gaetanoantonio,86,86,0,True,False
claudiogiuseppe,86,86,0,True,False
giovannimar,85,85,0,True,False
antoniocarmelo,85,85,0,True,False
benedikt,85,85,0,True,False
albertogiuseppe,85,85,0,True,False
mariavirginia,85,0,85,False,True
violetta,85,0,85,False,True
domenicocarlo,85,85,0,True,False
nunziatina,85,0,85,False,True
lukas,85,85,0,True,False
matteogiovanni,85,85,0,True,False
hartwig,85,85,0,True,False
franchino,85,85,0,True,False
stefanogiuseppe,85,85,0,True,False
adalbert,85,85,0,True,False
giusepperoberto,85,85,0,True,False
ascenzio,85,85,0,True,False
fiammetta,85,0,85,False,True
gianrenzo,85,85,0,True,False
radames,85,85,0,True,False
giusy,84,0,84,False,True
mariaserena,84,0,84,False,True
mariasanta,84,0,84,False,True
gesuina,84,0,84,False,True
wainer,84,84,0,True,False
antoniocarmine,84,84,0,True,False
giuseppefranco,84,84,0,True,False
medardo,84,84,0,True,False
lida,84,0,84,False,True
ercolano,84,84,0,True,False
mariaalberta,84,0,84,False,True
domeniconicola,84,84,0,True,False
idilio,84,84,0,True,False
giovannimarco,83,83,0,True,False
engelbert,83,83,0,True,False
piersergio,83,83,0,True,False
mauroluigi,83,83,0,True,False
ornello,83,83,0,True,False
rocchina,83,0,83,False,True
rubens,83,83,0,True,False
giansandro,83,83,0,True,False
magdalena,83,0,83,False,True
annemarie,83,0,83,False,True
mariafelicia,83,0,83,False,True
francangelo,83,83,0,True,False
aulo,83,83,0,True,False
alvio,83,83,0,True,False
francopaolo,83,83,0,True,False
gigi,83,83,0,True,False
giampaola,82,0,82,False,True
rosalbino,82,82,0,True,False
robertopaolo,82,82,0,True,False
teresita,82,0,82,False,True
gianalberto,82,82,0,True,False
antoniogerardo,82,82,0,True,False
enos,82,82,0,True,False
amedea,82,0,82,False,True
giovannimaurizio,82,82,0,True,False
colomba,82,0,82,False,True
caterino,82,82,0,True,False
agrippino,82,82,0,True,False
mariagiuliana,82,0,82,False,True
bortolino,82,82,0,True,False
christina,82,0,82,False,True
scipione,82,82,0,True,False
sperandio,82,82,0,True,False
pier,82,0,82,False,True
gertrud,81,0,81,False,True
lucamaria,81,76,5,True,False
albertomario,81,81,0,True,False
mariaclaudia,81,0,81,False,True
silviamaria,81,0,81,False,True
corradogiuseppe,81,81,0,True,False
antonioandrea,81,81,0,True,False
giangaetano,81,81,0,True,False
sonja,81,0,81,False,True
eldo,81,81,0,True,False
emil,81,81,0,True,False
roccovito,80,80,0,True,False
mariaadelaide,80,0,80,False,True
giovanfranco,80,80,0,True,False
alfredogiuseppe,80,80,0,True,False
hildegard,80,0,80,False,True
angelogabriele,80,80,0,True,False
renaldo,80,80,0,True,False
andreana,80,0,80,False,True
armida,80,0,80,False,True
pietroandrea,80,80,0,True,False
ignaziosalvatore,80,80,0,True,False
mariaaugusta,80,0,80,False,True
erberto,80,80,0,True,False
geniale,80,80,0,True,False
cristinamaria,80,0,80,False,True
tindara,80,0,80,False,True
cosimoantonio,80,80,0,True,False
gavina,80,0,80,False,True
argeo,80,80,0,True,False
ernestogiovanni,79,79,0,True,False
catena,79,0,79,False,True
nora,79,0,79,False,True
giacomopaolo,79,79,0,True,False
ritamaria,79,0,79,False,True
joseffranz,79,79,0,True,False
donella,79,0,79,False,True
salvatora,79,0,79,False,True
isauro,79,79,0,True,False
vincenzonicola,79,79,0,True,False
ledo,79,79,0,True,False
luigiandrea,79,79,0,True,False
salvatorepaolo,79,79,0,True,False
domenicofranco,79,79,0,True,False
mariajose',79,0,79,False,True
marcostefano,79,79,0,True,False
paris,79,79,0,True,False
giuseppeantonino,79,79,0,True,False
antoniopio,79,79,0,True,False
iliano,79,79,0,True,False
agnello,79,79,0,True,False
mauroangelo,78,78,0,True,False
susy,78,5,73,False,True
pierogiovanni,78,78,0,True,False
giuseppesaverio,78,78,0,True,False
saturno,78,78,0,True,False
theodor,78,78,0,True,False
maria,78,78,0,True,False
gianniantonio,78,78,0,True,False
paoloangelo,78,78,0,True,False
giacomogiuseppe,78,78,0,True,False
giancristoforo,78,78,0,True,False
gbattista,78,78,0,True,False
odoardo,78,78,0,True,False
giona,78,78,0,True,False
gioia,78,0,78,False,True
alfredino,78,78,0,True,False
luigimichele,78,78,0,True,False
iside,78,0,78,False,True
omobono,78,78,0,True,False
marioandrea,78,78,0,True,False
gloriana,77,0,77,False,True
ferrante,77,77,0,True,False
lauragiuseppina,77,0,77,False,True
albertocarlo,77,77,0,True,False
antonionatale,77,77,0,True,False
francescorosario,77,77,0,True,False
vilmer,77,77,0,True,False
vitoangelo,77,77,0,True,False
giuseppesanto,77,77,0,True,False
palmarino,77,77,0,True,False
venera,77,0,77,False,True
mariobruno,77,77,0,True,False
geminiano,77,77,0,True,False
carmelosalvatore,77,77,0,True,False
galeazzo,77,77,0,True,False
juan,77,77,0,True,False
mariasilvia,76,0,76,False,True
giannimario,76,76,0,True,False
learco,76,76,0,True,False
luciogiuseppe,76,76,0,True,False
carmelamaria,76,0,76,False,True
ignaziogiuseppe,76,76,0,True,False
doretta,76,0,76,False,True
sergiogiovanni,76,76,0,True,False
ivanoe,76,76,0,True,False
antoniobruno,76,76,0,True,False
umbro,76,76,0,True,False
incoronata,76,0,76,False,True
mercurio,76,76,0,True,False
callisto,76,76,0,True,False
giovannaantonia,76,0,76,False,True
milco,76,76,0,True,False
august,75,75,0,True,False
morgan,75,75,0,True,False
diomira,75,0,75,False,True
marialuise,75,0,75,False,True
barbato,75,75,0,True,False
agapito,75,75,0,True,False
paolocarlo,75,75,0,True,False
mirando,75,75,0,True,False
giovanniemilio,75,75,0,True,False
johannlorenz,75,75,0,True,False
margit,75,5,70,False,True
alfonsomaria,75,75,0,True,False
angioletto,75,75,0,True,False
zenone,75,75,0,True,False
henry,75,75,0,True,False
lucaantonio,75,75,0,True,False
ugolino,75,75,0,True,False
genoveffa,75,0,75,False,True
viscardo,75,75,0,True,False
ilvano,75,75,0,True,False
damiana,74,0,74,False,True
mariodonato,74,74,0,True,False
francescovincenzo,74,74,0,True,False
alessandroluigi,74,74,0,True,False
mariaeugenia,74,0,74,False,True
michelarcangelo,74,74,0,True,False
michelenicola,74,74,0,True,False
eziogiovanni,74,74,0,True,False
agnes,74,0,74,False,True
francoignazio,74,74,0,True,False
potito,74,74,0,True,False
mascia,74,1,73,False,True
venerino,74,74,0,True,False
giuseppevito,74,74,0,True,False
mariaida,74,0,74,False,True
carlopaolo,74,74,0,True,False
giannimaria,74,74,0,True,False
rosato,74,74,0,True,False
antoniolucio,74,74,0,True,False
altero,74,74,0,True,False
novello,74,74,0,True,False
nicolapasquale,73,73,0,True,False
antoniofernando,73,73,0,True,False
uliano,73,73,0,True,False
cosmodamiano,73,73,0,True,False
belinda,73,0,73,False,True
ezioluigi,73,73,0,True,False
diletta,73,0,73,False,True
mariacandida,73,0,73,False,True
vivenzio,73,73,0,True,False
ulrike,73,0,73,False,True
alina,73,0,73,False,True
edi,73,73,0,True,False
validio,73,73,0,True,False
alighiero,73,73,0,True,False
albarosa,73,0,73,False,True
johanngeorg,73,73,0,True,False
saulo,73,73,0,True,False
michaela,73,0,73,False,True
chiarina,73,0,73,False,True
leoluca,73,73,0,True,False
luigipasquale,73,73,0,True,False
diodoro,73,73,0,True,False
evi,73,0,73,False,True
antoniodonato,72,72,0,True,False
agostinomario,72,72,0,True,False
valdi,72,72,0,True,False
ario,72,72,0,True,False
azelio,72,72,0,True,False
amorino,72,72,0,True,False
adonella,72,0,72,False,True
emiliomario,72,72,0,True,False
antoniogiorgio,72,72,0,True,False
nemo,72,72,0,True,False
alviero,72,72,0,True,False
castrese,72,72,0,True,False
salvatorina,72,5,67,False,True
gerry,72,72,0,True,False
angelobattista,72,72,0,True,False
peterpaul,72,72,0,True,False
brunofrancesco,72,72,0,True,False
elisamaria,72,0,72,False,True
francescoandrea,72,72,0,True,False
renatoluigi,72,72,0,True,False
francogiacomo,72,72,0,True,False
domenicosavio,72,72,0,True,False
gianpaola,71,0,71,False,True
muzio,71,71,0,True,False
eraclio,71,71,0,True,False
paologiorgio,71,71,0,True,False
ausilia,71,0,71,False,True
pierleonardo,71,71,0,True,False
baingio,71,71,0,True,False
antoniamaria,71,0,71,False,True
mariodaniele,71,71,0,True,False
cesaregiuseppe,71,71,0,True,False
salvatoredomenico,71,71,0,True,False
mariolino,71,71,0,True,False
umbertoluigi,71,71,0,True,False
birgit,71,0,71,False,True
mariaannunziata,71,0,71,False,True
tanja,71,0,71,False,True
laurino,71,71,0,True,False
ancilla,71,0,71,False,True
beatrix,70,0,70,False,True
guerriero,70,70,0,True,False
andreaantonio,70,70,0,True,False
teodorico,70,70,0,True,False
antoniogavino,70,70,0,True,False
defendente,70,70,0,True,False
galileo,70,70,0,True,False
michelemario,70,70,0,True,False
antonioalberto,70,70,0,True,False
giulianogiuseppe,70,70,0,True,False
umbertoantonio,70,70,0,True,False
ottone,70,70,0,True,False
jonny,70,70,0,True,False
matteomaria,70,70,0,True,False
erichjosef,70,70,0,True,False
soniamaria,70,0,70,False,True
enzogiuseppe,70,70,0,True,False
lorenzina,70,0,70,False,True
danteangelo,70,70,0,True,False
faliero,70,70,0,True,False
giovannienrico,70,70,0,True,False
elios,70,70,0,True,False
luigicarmine,70,70,0,True,False
floro,69,69,0,True,False
marilinda,69,0,69,False,True
vando,69,69,0,True,False
luigilivio,69,69,0,True,False
libera,69,0,69,False,True
gasparino,69,69,0,True,False
mariaalba,69,0,69,False,True
roccomario,69,69,0,True,False
ilva,69,0,69,False,True
coriolano,69,69,0,True,False
giovanniclaudio,69,69,0,True,False
oretta,69,0,69,False,True
giovannifilippo,69,69,0,True,False
giuseppecarmine,69,69,0,True,False
renatogiuseppe,69,69,0,True,False
orsolina,69,0,69,False,True
philipp,69,69,0,True,False
clorinda,69,0,69,False,True
maurizioluigi,68,68,0,True,False
antoniomarco,68,68,0,True,False
marita,68,0,68,False,True
emiliogiovanni,68,68,0,True,False
valdemaro,68,68,0,True,False
m,68,0,68,False,True
marietta,68,0,68,False,True
levino,68,68,0,True,False
giuseppeottavio,68,68,0,True,False
venceslao,68,68,0,True,False
ariella,68,0,68,False,True
luisanna,68,0,68,False,True
antonioaldo,68,68,0,True,False
lucina,68,0,68,False,True
ginevra,68,0,68,False,True
concettamaria,68,0,68,False,True
ave,68,0,68,False,True
egeo,68,68,0,True,False
nicolasalvatore,68,68,0,True,False
gionni,67,67,0,True,False
walburga,67,0,67,False,True
artur,67,67,0,True,False
ferrero,67,67,0,True,False
emanueleantonio,67,67,0,True,False
ermenegilda,67,0,67,False,True
domenicoalfonso,67,67,0,True,False
enricoantonio,67,67,0,True,False
piergaetano,67,67,0,True,False
matteoantonio,67,67,0,True,False
leonardantonio,67,67,0,True,False
mauriziogiovanni,67,67,0,True,False
brunoluigi,67,67,0,True,False
giovina,67,0,67,False,True
piermarino,67,67,0,True,False
marioalberto,67,67,0,True,False
angelocarmelo,67,67,0,True,False
carl,67,67,0,True,False
giuseppeambrogio,67,67,0,True,False
gianuario,67,67,0,True,False
vitoleonardo,67,67,0,True,False
diamante,67,66,1,True,False
osvalda,67,0,67,False,True
lelia,67,0,67,False,True
delmo,67,67,0,True,False
patricia,67,0,67,False,True
evelino,67,67,0,True,False
giuseppefelice,67,67,0,True,False
luigimarco,67,67,0,True,False
gianmassimo,67,67,0,True,False
raffaeleangelo,67,67,0,True,False
emiliogiuseppe,67,67,0,True,False
luigidomenico,67,67,0,True,False
antonioenrico,67,67,0,True,False
gigino,66,66,0,True,False
paoloandrea,66,66,0,True,False
nucio,66,66,0,True,False
antonellamaria,66,5,61,False,True
vittorioantonio,66,66,0,True,False
castrenze,66,66,0,True,False
alvano,66,66,0,True,False
giuseppetommaso,66,66,0,True,False
giuseppearmando,66,66,0,True,False
adrianogiovanni,66,66,0,True,False
fabriziomaria,66,66,0,True,False
angelofelice,66,66,0,True,False
catiuscia,66,0,66,False,True
giovbattista,66,66,0,True,False
edi,66,0,66,False,True
gianniluigi,66,66,0,True,False
pierenrico,66,66,0,True,False
sylvie,66,0,66,False,True
francomaria,66,66,0,True,False
antoniomatteo,66,66,0,True,False
antonangelo,66,66,0,True,False
giovannicarmine,66,66,0,True,False
mose,66,66,0,True,False
enricodomenico,65,65,0,True,False
pablo,65,65,0,True,False
pilade,65,65,0,True,False
orante,65,65,0,True,False
cesareantonio,65,65,0,True,False
viola,65,0,65,False,True
danielamaria,65,0,65,False,True
giacomomaria,65,65,0,True,False
gisela,65,0,65,False,True
antoniogiacomo,65,65,0,True,False
lucantonio,65,65,0,True,False
aldogiovanni,65,65,0,True,False
angelobruno,65,65,0,True,False
rosariogiuseppe,65,65,0,True,False
antoniomassimo,65,65,0,True,False
angelarita,65,0,65,False,True
angeloandrea,65,65,0,True,False
angelopasquale,65,65,0,True,False
marcomario,65,65,0,True,False
salvatoreluigi,65,65,0,True,False
michelegiovanni,65,65,0,True,False
johannjosef,65,65,0,True,False
milvio,65,65,0,True,False
zeffirino,65,65,0,True,False
annina,65,0,65,False,True
renatamaria,65,0,65,False,True
victor,64,64,0,True,False
annio,64,64,0,True,False
virgilia,64,0,64,False,True
renzomario,64,64,0,True,False
pieranna,64,0,64,False,True
ricciotti,64,64,0,True,False
nicolarocco,64,64,0,True,False
giovanniluciano,64,64,0,True,False
bettino,64,64,0,True,False
giovannigaetano,64,64,0,True,False
amico,64,64,0,True,False
lucianomario,64,64,0,True,False
giovannico,64,64,0,True,False
antoniodaniele,64,64,0,True,False
mireno,64,64,0,True,False
mariannina,64,0,64,False,True
angelovito,64,64,0,True,False
donatangelo,64,64,0,True,False
fanny,64,0,64,False,True
herman,64,64,0,True,False
claudiovincenzo,64,64,0,True,False
giusepperaffaele,64,64,0,True,False
antonioroberto,64,64,0,True,False
claudina,64,0,64,False,True
chantal,64,0,64,False,True
faustina,64,0,64,False,True
erico,64,64,0,True,False
trifone,64,64,0,True,False
vitomario,63,63,0,True,False
francescoenrico,63,63,0,True,False
vinzenz,63,63,0,True,False
angelostefano,63,63,0,True,False
oriella,63,0,63,False,True
lucaluigi,63,63,0,True,False
almiro,63,63,0,True,False
ugogiuseppe,63,63,0,True,False
cruciano,63,63,0,True,False
bice,63,0,63,False,True
pasqualegiuseppe,63,63,0,True,False
gabrieleangelo,63,63,0,True,False
willer,63,63,0,True,False
romedio,63,63,0,True,False
zelindo,63,63,0,True,False
francecso,63,63,0,True,False
pietrogiacomo,63,63,0,True,False
davidemaria,63,58,5,True,False
kety,63,0,63,False,True
giovacchino,63,58,5,True,False
eliogiuseppe,63,63,0,True,False
mauropaolo,62,62,0,True,False
daniella,62,0,62,False,True
leopold,62,62,0,True,False
calcedonio,62,62,0,True,False
marusca,62,2,60,False,True
tea,62,0,62,False,True
senatro,62,62,0,True,False
antoniettamaria,62,0,62,False,True
giovannigavino,62,62,0,True,False
marziale,62,62,0,True,False
giuseppegerardo,62,62,0,True,False
veraldo,62,62,0,True,False
marcelloluciano,62,62,0,True,False
eda,62,0,62,False,True
robertofrancesco,62,62,0,True,False
vincenzofranco,62,62,0,True,False
bastiano,62,62,0,True,False
valda,62,0,62,False,True
avelio,62,62,0,True,False
caterinamaria,62,0,62,False,True
gioele,62,62,0,True,False
valfrido,62,62,0,True,False
salvatoreleonardo,62,62,0,True,False
salvatoreandrea,62,62,0,True,False
armenio,62,62,0,True,False
nadir,62,62,0,True,False
luigialessandro,61,61,0,True,False
guidomaria,61,61,0,True,False
viktor,61,61,0,True,False
cosma,61,61,0,True,False
azzurra,61,0,61,False,True
salvatoreantonino,61,61,0,True,False
mariatiziana,61,0,61,False,True
flavioluigi,61,61,0,True,False
giacomobattista,61,61,0,True,False
publio,61,61,0,True,False
giovannirenato,61,61,0,True,False
josefalois,61,61,0,True,False
assunto,61,61,0,True,False
rudolfjosef,61,61,0,True,False
nildo,61,61,0,True,False
donatorocco,61,61,0,True,False
mercedes,61,0,61,False,True
pietromichele,61,61,0,True,False
robertocarlo,61,61,0,True,False
gerardomichele,61,61,0,True,False
rosariosalvatore,61,61,0,True,False
vittoriogiuseppe,61,61,0,True,False
antoniofelice,61,61,0,True,False
vincenzomichele,61,61,0,True,False
alesio,61,61,0,True,False
enricocarlo,61,61,0,True,False
valdino,61,61,0,True,False
antonioluciano,60,60,0,True,False
silvestra,60,0,60,False,True
crocefisso,60,60,0,True,False
angelodonato,60,60,0,True,False
ginomarco,60,60,0,True,False
giuliogiovanni,60,60,0,True,False
raffael,60,60,0,True,False
fabiofrancesco,60,60,0,True,False
nicolagerardo,60,60,0,True,False
francesconicola,60,60,0,True,False
flavioclaudio,60,60,0,True,False
vitofrancesco,60,60,0,True,False
karolina,60,0,60,False,True
roccovincenzo,60,60,0,True,False
georgia,60,0,60,False,True
tolmino,60,60,0,True,False
mariafederica,60,0,60,False,True
pedro,60,60,0,True,False
carlovittorio,60,60,0,True,False
gasperino,60,60,0,True,False
carloroberto,60,60,0,True,False
carloaugusto,60,60,0,True,False
francogino,60,60,0,True,False
josefjohann,60,60,0,True,False
antoniocesare,60,60,0,True,False
andrealuigi,60,60,0,True,False
margarethe,60,0,60,False,True
cosma,60,0,60,False,True
francosalvatore,60,60,0,True,False
enricamaria,59,0,59,False,True
mariogiacomo,59,59,0,True,False
fabrizioluigi,59,59,0,True,False
luciaanna,59,0,59,False,True
norina,59,0,59,False,True
eli,59,59,0,True,False
carminegiuseppe,59,59,0,True,False
giuseppegaetano,59,59,0,True,False
roccantonio,59,59,0,True,False
lorenzoantonio,59,59,0,True,False
lucianogiuseppe,59,59,0,True,False
mariagloria,59,0,59,False,True
werter,59,59,0,True,False
florinda,59,0,59,False,True
micheleandrea,59,59,0,True,False
mariaemanuela,59,0,59,False,True
assuntina,59,0,59,False,True
filippina,59,0,59,False,True
giovannipasquale,59,59,0,True,False
mariacarmina,59,0,59,False,True
arturogiovanni,59,59,0,True,False
euclide,59,59,0,True,False
vitomichele,59,59,0,True,False
bartolomeogiuseppe,58,58,0,True,False
veneranda,58,0,58,False,True
gianrico,58,58,0,True,False
silviocarlo,58,58,0,True,False
isolina,58,0,58,False,True
sergiopaolo,58,58,0,True,False
werther,58,58,0,True,False
alain,58,58,0,True,False
eugeniogiuseppe,58,58,0,True,False
diegomaria,58,58,0,True,False
dietmar,58,58,0,True,False
paolonicola,58,58,0,True,False
giuseppefabrizio,58,58,0,True,False
icilio,58,58,0,True,False
melina,58,0,58,False,True
mennato,58,58,0,True,False
emore,58,58,0,True,False
elga,58,0,58,False,True
mariolucio,58,58,0,True,False
hubertjosef,58,58,0,True,False
james,58,58,0,True,False
faustoantonio,58,58,0,True,False
antoninoangelo,58,58,0,True,False
rosino,58,58,0,True,False
davidegiuseppe,58,58,0,True,False
giorgioluigi,58,58,0,True,False
amatore,57,57,0,True,False
pietropio,57,57,0,True,False
pietroemilio,57,57,0,True,False
carmelosebastiano,57,57,0,True,False
giuseppefilippo,57,57,0,True,False
carminantonio,57,57,0,True,False
pierclaudio,57,57,0,True,False
menotti,57,57,0,True,False
annagiulia,57,0,57,False,True
ronaldo,57,57,0,True,False
tommasina,57,0,57,False,True
jader,57,52,5,True,False
valtero,57,57,0,True,False
giov,57,57,0,True,False
natalegiuseppe,57,57,0,True,False
tersilla,57,0,57,False,True
diletto,57,57,0,True,False
marialorenza,57,0,57,False,True
marialuciana,57,0,57,False,True
biagioantonio,57,57,0,True,False
brenno,57,57,0,True,False
anteo,57,57,0,True,False
alessandromaria,57,57,0,True,False
pierodomenico,57,57,0,True,False
remogiuseppe,57,57,0,True,False
giustiniano,57,57,0,True,False
giuseppevittorio,57,57,0,True,False
faustoluigi,57,57,0,True,False
mariocarmine,56,56,0,True,False
alfia,56,0,56,False,True
elodia,56,0,56,False,True
salvatorecarlo,56,56,0,True,False
mariacatena,56,0,56,False,True
mariabambina,56,4,52,False,True
giuseppemaurizio,56,56,0,True,False
monaldo,56,56,0,True,False
alderico,56,56,0,True,False
lodovica,56,0,56,False,True
clarissa,56,0,56,False,True
arno,56,56,0,True,False
louis,56,56,0,True,False
margareth,56,0,56,False,True
raffaeledomenico,56,56,0,True,False
ursula,56,0,56,False,True
danieleluigi,56,56,0,True,False
raffaelegiuseppe,56,56,0,True,False
katharina,56,0,56,False,True
luigigino,56,56,0,True,False
carlomichele,56,56,0,True,False
evelyn,56,0,56,False,True
irenemaria,56,0,56,False,True
brunonicola,56,56,0,True,False
reno,56,56,0,True,False
teofilo,56,56,0,True,False
isio,56,56,0,True,False
mariarina,56,0,56,False,True
valdimiro,55,55,0,True,False
cosimomario,55,55,0,True,False
urban,55,55,0,True,False
federigo,55,55,0,True,False
dinogiuseppe,55,55,0,True,False
vigil,55,55,0,True,False
santoro,55,55,0,True,False
annagiuseppina,55,0,55,False,True
consiglia,55,0,55,False,True
ettorina,55,0,55,False,True
waltergiuseppe,55,55,0,True,False
venerio,55,55,0,True,False
massimoantonio,55,55,0,True,False
albertoangelo,55,55,0,True,False
pieroeugenio,55,55,0,True,False
mariacristi,55,0,55,False,True
bortolomeo,55,55,0,True,False
giorgiofrancesco,55,55,0,True,False
nicolaluigi,55,55,0,True,False
aldopietro,55,55,0,True,False
gotthard,55,55,0,True,False
giuseppepasquale,55,55,0,True,False
karljosef,55,55,0,True,False
otmar,55,55,0,True,False
josefanton,55,55,0,True,False
jurgen,55,55,0,True,False
giuseppenatale,55,55,0,True,False
atanasio,55,55,0,True,False
paolodomenico,55,55,0,True,False
kurtjosef,55,55,0,True,False
teresia,55,0,55,False,True
andrej,55,55,0,True,False
verusca,55,0,55,False,True
mariocarmelo,55,55,0,True,False
brunofranco,55,55,0,True,False
mimma,55,0,55,False,True
nelly,55,0,55,False,True
felicetta,55,0,55,False,True
andreaemilio,55,55,0,True,False
pierofranco,55,55,0,True,False
marida,55,0,55,False,True
antonioagostino,55,55,0,True,False
marianella,55,0,55,False,True
ulrico,54,54,0,True,False
pierfausto,54,54,0,True,False
libertario,54,54,0,True,False
pierfilippo,54,54,0,True,False
cosimogiuseppe,54,54,0,True,False
sigrid,54,0,54,False,True
giorgetto,54,54,0,True,False
volmer,54,54,0,True,False
antonioemilio,54,54,0,True,False
sergiopietro,54,54,0,True,False
marinello,54,54,0,True,False
donatino,54,54,0,True,False
giuseppebartolomeo,54,54,0,True,False
mariarosalba,54,0,54,False,True
marialina,54,0,54,False,True
patriziamaria,54,0,54,False,True
gianpio,54,54,0,True,False
luigiroberto,54,54,0,True,False
taddeo,54,54,0,True,False
carmina,54,0,54,False,True
folco,54,54,0,True,False
antoniostefano,54,54,0,True,False
rinamaria,54,0,54,False,True
giacomopietro,54,54,0,True,False
mirian,54,0,54,False,True
vanes,54,54,0,True,False
gunter,54,54,0,True,False
gesumino,54,54,0,True,False
angelovincenzo,53,53,0,True,False
diva,53,0,53,False,True
robertopietro,53,53,0,True,False
simonegiuseppe,53,53,0,True,False
vittoriogiovanni,53,53,0,True,False
lucamarco,53,53,0,True,False
walther,53,53,0,True,False
giuseppeleonardo,53,53,0,True,False
fabiopaolo,53,53,0,True,False
clarice,53,0,53,False,True
theo,53,53,0,True,False
giuseppegiorgio,53,53,0,True,False
rosaldo,53,53,0,True,False
rosarioantonio,53,53,0,True,False
vitalia,53,0,53,False,True
luigieliseo,53,53,0,True,False
adelfo,53,53,0,True,False
francescoan,53,53,0,True,False
nillo,53,53,0,True,False
luiginatale,53,53,0,True,False
eleno,53,53,0,True,False
nicholas,53,53,0,True,False
giosafat,53,53,0,True,False
giovani,53,53,0,True,False
mariadonatella,53,0,53,False,True
tarquinio,53,53,0,True,False
fulvioangelo,53,53,0,True,False
giuseppeenrico,53,53,0,True,False
domenicoluigi,53,53,0,True,False
valterluigi,53,53,0,True,False
ermindo,53,53,0,True,False
iliana,53,0,53,False,True
guglielma,53,0,53,False,True
brunero,53,53,0,True,False
marioroberto,53,53,0,True,False
giacomofrancesco,53,53,0,True,False
domenicoenzo,53,53,0,True,False
adrianomario,53,53,0,True,False
signorino,53,53,0,True,False
giacomosalvatore,53,53,0,True,False
amanzio,52,52,0,True,False
francarlo,52,52,0,True,False
giuseppeignazio,52,52,0,True,False
annacaterina,52,0,52,False,True
paolarosa,52,0,52,False,True
argia,52,0,52,False,True
umberta,52,0,52,False,True
luise,52,0,52,False,True
ginesio,52,52,0,True,False
massimina,52,0,52,False,True
antoniodario,52,52,0,True,False
marioliberato,52,52,0,True,False
biagia,52,0,52,False,True
giovannantonio,52,52,0,True,False
marialoredana,52,0,52,False,True
giovannibenedetto,52,52,0,True,False
nicolantonio,52,52,0,True,False
giorgiocarlo,52,52,0,True,False
ferrando,52,52,0,True,False
mariafilomena,52,0,52,False,True
johannes,52,52,0,True,False
ivoantonio,52,52,0,True,False
girolama,52,0,52,False,True
liberio,52,52,0,True,False
maurizioantonio,52,52,0,True,False
luciofranco,52,52,0,True,False
attilioluigi,52,52,0,True,False
gianmartino,52,52,0,True,False
robertogiorgio,52,52,0,True,False
ernestomaria,52,52,0,True,False
josefine,52,0,52,False,True
vandamaria,52,0,52,False,True
rosalina,52,0,52,False,True
lucianoluigi,52,52,0,True,False
azio,52,52,0,True,False
mariaraffaella,52,0,52,False,True
nadiamaria,51,0,51,False,True
albo,51,51,0,True,False
gianrino,51,51,0,True,False
sestino,51,51,0,True,False
giovannaangela,51,0,51,False,True
ermannoluigi,51,51,0,True,False
domenicamaria,51,0,51,False,True
uliana,51,0,51,False,True
enri,51,51,0,True,False
pierluigimaria,51,51,0,True,False
giampiera,51,0,51,False,True
mariaclotilde,51,0,51,False,True
walterpietro,51,51,0,True,False
jolanda,51,0,51,False,True
antoniogaetano,51,51,0,True,False
frank,51,51,0,True,False
millo,51,51,0,True,False
gerard,51,51,0,True,False
ezioantonio,51,51,0,True,False
giovanniaugusto,51,51,0,True,False
pasqualemario,51,51,0,True,False
petronilla,51,0,51,False,True
guidopietro,51,51,0,True,False
salvatorematteo,51,51,0,True,False
albamaria,51,0,51,False,True
aldomario,51,51,0,True,False
aldofrancesco,51,51,0,True,False
monicamaria,51,0,51,False,True
leonardogiuseppe,51,51,0,True,False
nicolasergio,51,51,0,True,False
tomasino,51,51,0,True,False
avellino,51,51,0,True,False
liateresa,51,0,51,False,True
aloiskarl,51,51,0,True,False
piercesare,51,51,0,True,False
francescopietro,51,51,0,True,False
saro,51,51,0,True,False
fabiomaria,51,51,0,True,False
albrecht,51,51,0,True,False
santoantonio,51,51,0,True,False
fortuna,51,1,50,False,True
claretta,51,0,51,False,True
giuseppecesare,51,51,0,True,False
dovilio,51,51,0,True,False
iana,51,0,51,False,True
argante,51,51,0,True,False
giovannilino,51,51,0,True,False
nerella,51,0,51,False,True
paolofranco,51,51,0,True,False
ramon,51,51,0,True,False
oddino,51,51,0,True,False
cettina,51,0,51,False,True
carminedomenico,51,51,0,True,False
angelonatale,51,51,0,True,False
gaetanogiovanni,50,50,0,True,False
fabioantonio,50,50,0,True,False
giuseppeedoardo,50,50,0,True,False
giovanniguido,50,50,0,True,False
mariolorenzo,50,50,0,True,False
fabiogiovanni,50,50,0,True,False
massimoluigi,50,50,0,True,False
saverioantonio,50,50,0,True,False
ideo,50,50,0,True,False
enzocarlo,50,50,0,True,False
firmo,50,50,0,True,False
franceschina,50,0,50,False,True
giombattista,50,50,0,True,False
spiridione,50,50,0,True,False
roccofranco,50,50,0,True,False
emilioangelo,50,50,0,True,False
lorenzogiulio,50,50,0,True,False
ruth,50,0,50,False,True
theresia,50,0,50,False,True
settimia,50,0,50,False,True
tullioalberto,50,50,0,True,False
ermelino,50,50,0,True,False
sieglinde,50,0,50,False,True
albertoantonio,50,50,0,True,False
ugogiovanni,50,50,0,True,False
hedwig,50,0,50,False,True
giuseppestefano,50,50,0,True,False
guidogiovanni,50,50,0,True,False
primaldo,50,50,0,True,False
gianattilio,50,50,0,True,False
guidoantonio,50,50,0,True,False
graziaangela,50,0,50,False,True
edoarda,50,0,50,False,True
piergino,50,50,0,True,False
alferio,50,50,0,True,False
francescopio,50,50,0,True,False
paoletta,50,0,50,False,True
tersillo,50,50,0,True,False
salvatorenicola,50,50,0,True,False
geraldo,50,50,0,True,False
florenzo,50,50,0,True,False
gerardoantonio,50,50,0,True,False
raffaelino,50,50,0,True,False
antoniopaolo,50,50,0,True,False
antoniorosario,50,50,0,True,False
norman,50,50,0,True,False
armandino,50,50,0,True,False
hartwigfriedrich,50,50,0,True,False
aloispeter,50,50,0,True,False
ostilio,50,50,0,True,False
thomasanton,50,50,0,True,False
ernamaria,50,0,50,False,True
linamaria,50,0,50,False,True
giannibattista,50,50,0,True,False
luigicosimo,50,50,0,True,False
addolorato,49,49,0,True,False
giuliobenito,49,49,0,True,False
myriam,49,0,49,False,True
leonino,49,49,0,True,False
falco,49,49,0,True,False
giuseppeant,49,49,0,True,False
marcelloantonio,49,49,0,True,False
fabiopietro,49,49,0,True,False
fabiomassimo,49,49,0,True,False
giuseppecosimo,49,49,0,True,False
magno,49,49,0,True,False
umbertocarlo,49,49,0,True,False
luigigiusep,49,49,0,True,False
helmutjosef,49,49,0,True,False
alvero,49,49,0,True,False
enzomario,49,49,0,True,False
licinio,49,49,0,True,False
guelfo,49,49,0,True,False
giuseppeguido,49,49,0,True,False
umbertomario,49,49,0,True,False
esmeralda,49,0,49,False,True
giovannicosimo,49,49,0,True,False
gerardomario,49,49,0,True,False
guendalina,49,0,49,False,True
assuntino,49,49,0,True,False
giovannirocco,49,49,0,True,False
mike,49,49,0,True,False
renzogiuseppe,49,49,0,True,False
claudiomario,49,49,0,True,False
elvia,49,0,49,False,True
giovannigiulio,49,49,0,True,False
francopietro,49,49,0,True,False
mariaregina,49,0,49,False,True
ottavino,49,49,0,True,False
renatofrancesco,49,49,0,True,False
paologiacomo,49,49,0,True,False
mauromaria,49,49,0,True,False
domizia,49,0,49,False,True
antonioalfredo,49,49,0,True,False
jennifer,49,0,49,False,True
judith,49,0,49,False,True
gianfrancomaria,49,49,0,True,False
ginogiuseppe,49,49,0,True,False
mariomarcello,49,49,0,True,False
flaviotomaso,49,49,0,True,False
mariaester,49,0,49,False,True
norino,49,49,0,True,False
afra,48,0,48,False,True
toninoabate,48,48,0,True,False
francoangelo,48,48,0,True,False
everardo,48,48,0,True,False
giangiorgio,48,48,0,True,False
giuseppemarco,48,48,0,True,False
alfredomario,48,48,0,True,False
gianfermo,48,48,0,True,False
piererminio,48,48,0,True,False
edio,48,48,0,True,False
alviano,48,48,0,True,False
lieto,48,48,0,True,False
gianbortolo,48,48,0,True,False
edoardoandrea,48,48,0,True,False
gianlauro,48,48,0,True,False
mentore,48,48,0,True,False
aloisia,48,0,48,False,True
maurizioclaudio,48,48,0,True,False
lucilio,48,48,0,True,False
prosperino,48,48,0,True,False
gaetanofrancesco,48,48,0,True,False
annaclaudia,48,0,48,False,True
favio,48,48,0,True,False
sergioluigi,48,48,0,True,False
isaccoprimo,48,48,0,True,False
domenicomaria,48,48,0,True,False
fiamma,48,0,48,False,True
annabruna,48,0,48,False,True
luciopaolo,48,48,0,True,False
pietrolorenzo,48,48,0,True,False
herwin,48,48,0,True,False
hermannbernhard,48,48,0,True,False
anselma,48,0,48,False,True
pietroaugusto,48,48,0,True,False
marcopaolo,48,48,0,True,False
carloemanuele,48,48,0,True,False
nilla,48,0,48,False,True
marilina,48,0,48,False,True
silvietto,48,48,0,True,False
carloedoardo,48,48,0,True,False
andreasjosef,48,48,0,True,False
gianniangelo,48,48,0,True,False
ana,48,0,48,False,True
claudioluigi,48,48,0,True,False
pieroemilio,48,48,0,True,False
armandodomenico,48,48,0,True,False
provvidenza,48,0,48,False,True
darioluigi,48,48,0,True,False
giuseppelucio,47,47,0,True,False
angelogiosue',47,47,0,True,False
francoaugusto,47,47,0,True,False
lois,47,47,0,True,False
aldoenrico,47,47,0,True,False
bastianino,47,47,0,True,False
dirce,47,0,47,False,True
ingeborg,47,0,47,False,True
albertopasquale,47,47,0,True,False
giselda,47,0,47,False,True
giacomomario,47,47,0,True,False
piermaurizio,47,47,0,True,False
emidia,47,0,47,False,True
gustaverich,47,47,0,True,False
jeanclaude,47,47,0,True,False
adrianopietro,47,47,0,True,False
almo,47,47,0,True,False
danilogiovanni,47,47,0,True,False
gaetanogiuseppe,47,47,0,True,False
giovannimassimo,47,47,0,True,False
amalio,47,47,0,True,False
mariafulvia,47,0,47,False,True
giuliomario,47,47,0,True,False
mariaivana,47,0,47,False,True
eliomario,47,47,0,True,False
santogiuseppe,47,47,0,True,False
giovannimarcello,47,47,0,True,False
nazarena,47,0,47,False,True
giorgioantonio,47,47,0,True,False
orlanda,47,0,47,False,True
marioraffaele,47,47,0,True,False
fabrizioangelo,47,47,0,True,False
mariorenato,47,47,0,True,False
marciano,47,47,0,True,False
martamaria,47,0,47,False,True
anto,47,47,0,True,False
delfio,47,47,0,True,False
giovanniemanuele,47,47,0,True,False
marcoemilio,47,47,0,True,False
arnoldo,47,47,0,True,False
gigetto,47,47,0,True,False
cinziamaria,47,0,47,False,True
luigiclaudio,47,47,0,True,False
angelolino,47,47,0,True,False
giantonio,47,47,0,True,False
domenicopietro,47,47,0,True,False
luigibattista,47,47,0,True,False
giansante,47,47,0,True,False
elido,47,47,0,True,False
tilde,46,2,44,False,True
mariocosimo,46,46,0,True,False
johnny,46,46,0,True,False
andreafrancesco,46,46,0,True,False
giacomosergio,46,46,0,True,False
contardo,46,46,0,True,False
gianpeppino,46,46,0,True,False
gilberta,46,0,46,False,True
walterfranz,46,46,0,True,False
leonhard,46,46,0,True,False
simplicio,46,46,0,True,False
gabriellamaria,46,0,46,False,True
giovannarosa,46,0,46,False,True
carminenicola,46,46,0,True,False
alvino,46,46,0,True,False
claudiomaurizio,46,46,0,True,False
giovannimauro,46,46,0,True,False
carloalessandro,46,46,0,True,False
bonaria,46,0,46,False,True
paolovincenzo,46,46,0,True,False
sergioclaudio,46,46,0,True,False
gaetanino,46,46,0,True,False
pompea,46,0,46,False,True
giovmaria,46,46,0,True,False
gianfrancoantonio,46,46,0,True,False
robertomartino,46,46,0,True,False
klara,46,0,46,False,True
giuseppefausto,46,46,0,True,False
derio,46,46,0,True,False
salvina,46,0,46,False,True
adrianoluigi,46,46,0,True,False
basso,46,46,0,True,False
oddo,46,46,0,True,False
eris,46,46,0,True,False
cosimodomenico,46,46,0,True,False
luisnorbert,46,46,0,True,False
beppe,46,46,0,True,False
cesareantonino,46,46,0,True,False
biagiosalvatore,46,46,0,True,False
annabella,46,0,46,False,True
agostinogiuseppe,46,46,0,True,False
alenka,46,0,46,False,True
ivio,46,46,0,True,False
lucianofrancesco,46,46,0,True,False
annelies,45,0,45,False,True
carmelomaria,45,45,0,True,False
frida,45,0,45,False,True
donatofrancesco,45,45,0,True,False
carminemichele,45,45,0,True,False
francescaangela,45,0,45,False,True
lolita,45,0,45,False,True
carloamedeo,45,45,0,True,False
emilioluigi,45,45,0,True,False
ascenzo,45,45,0,True,False
luciaangela,45,0,45,False,True
aligi,45,45,0,True,False
crocifisso,45,45,0,True,False
josette,45,0,45,False,True
brunhilde,45,0,45,False,True
peppina,45,0,45,False,True
mariagina,45,0,45,False,True
sibilla,45,0,45,False,True
mariaines,45,0,45,False,True
christophwerner,45,45,0,True,False
cosmadamiano,45,45,0,True,False
edmundjosef,45,45,0,True,False
brunoangelo,45,45,0,True,False
albertostefano,45,45,0,True,False
diomede,45,45,0,True,False
ellade,45,0,45,False,True
elladegiacinta,45,0,45,False,True
antongiulio,45,45,0,True,False
orianna,45,0,45,False,True
marialidia,45,0,45,False,True
zenobbia,45,0,45,False,True
italomario,45,45,0,True,False
raffaelenicola,45,45,0,True,False
giuseppepio,45,45,0,True,False
karlmarkus,45,45,0,True,False
fritzkarl,45,45,0,True,False
gianbruno,45,45,0,True,False
peterroman,45,45,0,True,False
odo,45,45,0,True,False
massimomichele,45,45,0,True,False
umbertovincenzo,45,45,0,True,False
onesto,45,45,0,True,False
giovanninicola,45,45,0,True,False
rolandoantonio,45,45,0,True,False
umbertogiuseppe,45,45,0,True,False
lucillo,45,45,0,True,False
giovannitommaso,45,45,0,True,False
giansilvio,45,45,0,True,False
robertoernesto,45,45,0,True,False
luigienrico,45,45,0,True,False
fulio,45,45,0,True,False
salvatoremichele,45,45,0,True,False
giorgiodomenico,45,45,0,True,False
giuseppeernesto,45,45,0,True,False
sighard,45,45,0,True,False
federicomaria,45,45,0,True,False
pietroumberto,45,45,0,True,False
marcodomenico,45,45,0,True,False
linoangelo,45,45,0,True,False
maxkarl,45,45,0,True,False
luigiagostino,45,45,0,True,False
piernicola,45,45,0,True,False
gesuele,44,44,0,True,False
brunocarlo,44,44,0,True,False
robertovittorio,44,44,0,True,False
domenicovito,44,44,0,True,False
giulianamaria,44,0,44,False,True
aurelioantonio,44,44,0,True,False
traiano,44,44,0,True,False
paoloenzo,44,44,0,True,False
elvo,44,44,0,True,False
flaminia,44,0,44,False,True
raffaelemaria,44,44,0,True,False
pietroeugenio,44,44,0,True,False
pioantonio,44,44,0,True,False
paolamargherita,44,0,44,False,True
vittoriopietro,44,44,0,True,False
pietroalessandro,44,44,0,True,False
paolomichele,44,44,0,True,False
marioabele,44,44,0,True,False
colombano,44,44,0,True,False
giandaniele,44,44,0,True,False
pellegro,44,44,0,True,False
anchise,44,44,0,True,False
carlocosimo,44,44,0,True,False
giancamillo,44,44,0,True,False
ritamaddalena,44,0,44,False,True
juliane,44,0,44,False,True
giovannifederico,44,44,0,True,False
gianroberto,44,44,0,True,False
nunzioantonio,44,44,0,True,False
mariarosanna,44,0,44,False,True
deodato,44,44,0,True,False
nicolavito,44,44,0,True,False
vincenzoeugenio,44,44,0,True,False
antonioonorato,44,44,0,True,False
vincenzodomenico,44,44,0,True,False
nicolagiovanni,44,44,0,True,False
mariaceleste,44,0,44,False,True
mariaclelia,44,0,44,False,True
sebastianogiuseppe,44,44,0,True,False
linocarlo,44,44,0,True,False
giovanniagostino,44,44,0,True,False
fernandogiuseppe,44,44,0,True,False
giovannicarmelo,44,44,0,True,False
annalina,44,0,44,False,True
micheleraffaele,44,44,0,True,False
annadomenica,44,0,44,False,True
vincenzopaolo,44,44,0,True,False
floreano,44,44,0,True,False
idelfonso,44,44,0,True,False
giovanniroberto,44,44,0,True,False
rosvaldo,44,44,0,True,False
lucafederico,44,44,0,True,False
orlandino,44,44,0,True,False
roccodonato,44,44,0,True,False
riccardogiuseppe,43,43,0,True,False
willi,43,43,0,True,False
fabrizioivano,43,43,0,True,False
simonettamaria,43,0,43,False,True
giuseppelivio,43,43,0,True,False
sergiorenato,43,43,0,True,False
rinogiuseppe,43,43,0,True,False
luigiluciano,43,43,0,True,False
eziomaria,43,43,0,True,False
corradomaria,43,43,0,True,False
florino,43,43,0,True,False
priska,43,0,43,False,True
alessandroantonio,43,43,0,True,False
luiginazzareno,43,43,0,True,False
amor,43,43,0,True,False
francostefano,43,43,0,True,False
bernardetta,43,0,43,False,True
dariogiovanni,43,43,0,True,False
edvigio,43,43,0,True,False
pieraanna,43,0,43,False,True
giuseppebenito,43,43,0,True,False
silvester,43,43,0,True,False
tizianamaria,43,1,42,False,True
mattea,43,0,43,False,True
marioumile,43,43,0,True,False
pantaleoluigi,43,43,0,True,False
marisella,43,0,43,False,True
giannipietro,43,43,0,True,False
armindo,43,43,0,True,False
gianvalerio,43,43,0,True,False
ugodomenico,43,43,0,True,False
armandoandreino,43,43,0,True,False
vairo,43,43,0,True,False
argenio,43,43,0,True,False
antoninomaria,43,43,0,True,False
valeriogiuseppe,43,43,0,True,False
nobile,43,43,0,True,False
giovannimatteo,43,43,0,True,False
ildefonso,43,43,0,True,False
nicolao,43,43,0,True,False
antoniogabriele,43,43,0,True,False
mariagabriela,43,0,43,False,True
marialinda,43,0,43,False,True
marialorella,43,0,43,False,True
enzogiovanni,43,43,0,True,False
vitosalvatore,43,43,0,True,False
lorenamaria,43,0,43,False,True
piercamillo,43,43,0,True,False
vladimir,43,43,0,True,False
ettoreantonio,43,43,0,True,False
marcofranco,43,43,0,True,False
andreasalvatore,43,43,0,True,False
giacomoluigi,43,43,0,True,False
marcoandrea,43,43,0,True,False
waltergiovanni,43,43,0,True,False
carlogiorgio,43,43,0,True,False
giordanobruno,42,42,0,True,False
gaetanosalvatore,42,42,0,True,False
saverino,42,42,0,True,False
antoniogiulio,42,42,0,True,False
nazzaro,42,42,0,True,False
giovannivito,42,42,0,True,False
lindoro,42,42,0,True,False
sepp,42,42,0,True,False
michelefrancesco,42,42,0,True,False
michelesalvatore,42,42,0,True,False
micheleroberto,42,42,0,True,False
marc,42,42,0,True,False
palmamaria,42,0,42,False,True
marialorena,42,0,42,False,True
salvatorerocco,42,42,0,True,False
davis,42,42,0,True,False
rafaele,42,42,0,True,False
antoniosebastiano,42,42,0,True,False
cosimosalvatore,42,42,0,True,False
leana,42,0,42,False,True
leonilda,42,0,42,False,True
julia,42,0,42,False,True
reinholdantonio,42,42,0,True,False
marioluciano,42,42,0,True,False
palmo,42,42,0,True,False
angelomarino,42,42,0,True,False
carlovincenzo,42,42,0,True,False
amo,42,42,0,True,False
gianbernardo,42,42,0,True,False
giulioantonio,42,42,0,True,False
rudolfchristian,42,42,0,True,False
ethel,42,0,42,False,True
massimoomar,42,42,0,True,False
fortunatoantonio,42,42,0,True,False
giuliomaria,42,42,0,True,False
angeloenrico,42,42,0,True,False
pierfranca,42,0,42,False,True
vincenzorocco,42,42,0,True,False
evelio,42,42,0,True,False
vitoluigi,42,42,0,True,False
eliogiovanni,42,42,0,True,False
euprepio,42,42,0,True,False
teodolinda,42,0,42,False,True
vannio,42,42,0,True,False
jonni,42,42,0,True,False
walterumberto,42,42,0,True,False
gianvittore,41,41,0,True,False
salvatorelorenzo,41,41,0,True,False
ludovica,41,0,41,False,True
giovanniriccardo,41,41,0,True,False
vitocarlo,41,41,0,True,False
maida,41,0,41,False,True
marjan,41,41,0,True,False
triestino,41,41,0,True,False
mariorosario,41,41,0,True,False
fabioangelo,41,41,0,True,False
venicio,41,41,0,True,False
mariasaveria,41,2,39,False,True
emiliogabriele,41,41,0,True,False
santonatale,41,41,0,True,False
alessandrofrancesco,41,41,0,True,False
alessandrino,41,41,0,True,False
antoniotommaso,41,41,0,True,False
antoniosergio,41,41,0,True,False
sinibaldo,41,41,0,True,False
ferrucciogiuseppe,41,41,0,True,False
mariaamalia,41,0,41,False,True
vincenzodonato,41,41,0,True,False
giuseppericcardo,41,41,0,True,False
gianleo,41,41,0,True,False
ivanolorenzo,41,41,0,True,False
baldovino,41,41,0,True,False
giuliomichele,41,41,0,True,False
pietrovincenzo,41,41,0,True,False
policarpo,41,41,0,True,False
fiorina,41,0,41,False,True
pietronatale,41,41,0,True,False
ornellamaria,41,0,41,False,True
tertulliano,41,41,0,True,False
cinzio,41,41,0,True,False
odilia,41,0,41,False,True
piervalentino,41,41,0,True,False
ambrogino,41,41,0,True,False
amalfi,41,41,0,True,False
ventura,41,41,0,True,False
jeanpaul,41,41,0,True,False
piergiorgiosaverio,41,41,0,True,False
ezechiele,41,41,0,True,False
pierfederico,41,41,0,True,False
rivo,41,41,0,True,False
ezioantonioluigi,41,41,0,True,False
robertosante,41,41,0,True,False
egidiodomenico,41,41,0,True,False
mariabianca,41,0,41,False,True
bellarmino,41,41,0,True,False
nicolapietro,41,41,0,True,False
andreacarlo,41,41,0,True,False
nearco,41,41,0,True,False
antonetta,41,0,41,False,True
antonioferdinando,41,41,0,True,False
mariajose,41,0,41,False,True
donatogiuseppe,41,41,0,True,False
antoniogiustino,41,41,0,True,False
mariaisabella,41,0,41,False,True
illuminato,41,41,0,True,False
selvino,41,41,0,True,False
giovanniarturo,41,41,0,True,False
mariadora,41,0,41,False,True
verino,41,41,0,True,False
peterjosef,40,40,0,True,False
riccarda,40,0,40,False,True
johannbaptist,40,40,0,True,False
mira,40,0,40,False,True
annamariateresa,40,0,40,False,True
gianmanuele,40,40,0,True,False
giovannisergio,40,40,0,True,False
giancarloantonio,40,40,0,True,False
felicetto,40,40,0,True,False
bonifazio,40,40,0,True,False
luigirocco,40,40,0,True,False
titoromolo,40,40,0,True,False
danielo,40,40,0,True,False
albertofrancesco,40,40,0,True,False
annunciato,40,40,0,True,False
palmirofranco,40,40,0,True,False
mariovirginio,40,40,0,True,False
emmamaria,40,0,40,False,True
danielemarco,40,40,0,True,False
giovannia,40,40,0,True,False
brunovirgilio,40,40,0,True,False
francovittorio,40,40,0,True,False
isaura,40,0,40,False,True
roseo,40,40,0,True,False
giuseppeagostino,40,40,0,True,False
giuseppegiuliano,40,40,0,True,False
siegmund,40,40,0,True,False
eufrasio,40,40,0,True,False
tommasoantonio,40,40,0,True,False
mariangiola,40,0,40,False,True
giovannibruno,40,40,0,True,False
pieroalberto,40,40,0,True,False
francescogaetano,40,40,0,True,False
giuliomarioluigi,40,40,0,True,False
giancarlomaria,40,40,0,True,False
luigimauro,40,40,0,True,False
remy,40,40,0,True,False
iader,40,40,0,True,False
temistocle,40,40,0,True,False
toninofranco,40,40,0,True,False
wolfango,40,40,0,True,False
angelosilvio,40,40,0,True,False
vittoriopaolo,40,40,0,True,False
renatoantonio,40,40,0,True,False
giambattistino,40,40,0,True,False
massimiliana,40,0,40,False,True
giangaspare,40,40,0,True,False
pauljosef,40,40,0,True,False
vitodario,40,40,0,True,False
silvioantonio,40,40,0,True,False
robertorobert,40,40,0,True,False
bernadette,40,0,40,False,True
dinocarlo,40,40,0,True,False
filippomario,40,40,0,True,False
silvanopaolino,40,40,0,True,False
andreafranco,40,40,0,True,False
thomasjosefhermann,40,40,0,True,False
giorgiosalvatore,40,40,0,True,False
mariasalvatora,40,0,40,False,True
ferlando,40,40,0,True,False
provino,40,40,0,True,False
oscarenrico,40,40,0,True,False
luisito,40,40,0,True,False
nullo,40,40,0,True,False
brunoandrea,40,40,0,True,False
aldobruno,40,40,0,True,False
maino,40,40,0,True,False
maico,40,40,0,True,False
andreaangelo,40,40,0,True,False
mariapasqua,40,0,40,False,True
pierdamiano,40,40,0,True,False
secondina,40,0,40,False,True
luigivito,40,40,0,True,False
donatosalvatore,40,40,0,True,False
elioemilio,40,40,0,True,False
adastro,40,40,0,True,False
italoantonio,40,40,0,True,False
miguel,40,40,0,True,False
leardo,40,40,0,True,False
pietrodonato,40,40,0,True,False
ferdinandoantonio,40,40,0,True,False
felicepietro,40,40,0,True,False
frederic,40,40,0,True,False
eustachius,40,40,0,True,False
alessandrogiovanni,40,40,0,True,False
raimondino,40,40,0,True,False
zeffiro,40,40,0,True,False
varis,40,40,0,True,False
cesareangelo,40,40,0,True,False
mariocelestino,40,40,0,True,False
flavioantonio,40,40,0,True,False
massimogiovanni,40,40,0,True,False
utilio,40,40,0,True,False
silvanomaria,40,40,0,True,False
marianazzarena,40,0,40,False,True
mariagavina,39,0,39,False,True
rizzieri,39,39,0,True,False
pierernesto,39,39,0,True,False
giambortolo,39,39,0,True,False
innocenzio,39,39,0,True,False
pietroaldo,39,39,0,True,False
adolfa,39,0,39,False,True
tonia,39,0,39,False,True
felicina,39,0,39,False,True
privato,39,39,0,True,False
micheleluigi,39,39,0,True,False
amore,39,39,0,True,False
carmelinofranco,39,39,0,True,False
catullo,39,39,0,True,False
gelsirio,39,39,0,True,False
carlosalvatore,39,39,0,True,False
marcelloaldo,39,39,0,True,False
pietrobernardo,39,39,0,True,False
gianbeppe,39,39,0,True,False
raffaelina,39,0,39,False,True
andreuccio,39,39,0,True,False
gerardogiuseppe,39,39,0,True,False
ambros,39,39,0,True,False
elisabettamaria,39,0,39,False,True
annacarmela,39,0,39,False,True
luigipiero,39,39,0,True,False
caludio,39,39,0,True,False
renatopietro,39,39,0,True,False
egidia,39,0,39,False,True
edimaria,39,0,39,False,True
luigigiancarlo,39,39,0,True,False
biagiopietro,39,39,0,True,False
enzoluigi,39,39,0,True,False
gianvirginio,39,39,0,True,False
giblanoroberto,39,39,0,True,False
ligurio,39,39,0,True,False
giblano,39,39,0,True,False
vannes,39,39,0,True,False
denio,39,39,0,True,False
deni,39,39,0,True,False
annito,39,39,0,True,False
salvatoresebastiano,39,39,0,True,False
sergiofrancesco,39,39,0,True,False
marioclaudio,39,39,0,True,False
ageo,39,39,0,True,False
ivangiovanni,39,39,0,True,False
rositano,39,39,0,True,False
giovannialessandro,39,39,0,True,False
emiliopasquale,39,39,0,True,False
flaviogiacomo,39,39,0,True,False
barbaro,39,39,0,True,False
enricobruno,39,39,0,True,False
valterio,39,39,0,True,False
valmore,39,39,0,True,False
giorgiopaolo,39,39,0,True,False
nuccio,39,39,0,True,False
mariarosella,39,0,39,False,True
nunziogiovanni,39,39,0,True,False
fileno,39,39,0,True,False
omer,39,39,0,True,False
giuseppesecondo,39,39,0,True,False
dinoalberto,39,39,0,True,False
maggiorina,39,0,39,False,True
giusepperenato,39,39,0,True,False
longino,39,39,0,True,False
massimoangelo,39,39,0,True,False
giovannivittorio,39,39,0,True,False
karen,39,0,39,False,True
francescopa,39,39,0,True,False
stefanomassimo,39,39,0,True,False
giovanniattilio,39,39,0,True,False
luigiemidio,39,39,0,True,False
gianberto,39,39,0,True,False
cora,39,0,39,False,True
domeniconicolino,39,39,0,True,False
dalido,39,39,0,True,False
modesta,39,0,39,False,True
lucianovincenzo,39,39,0,True,False
feliceelio,39,39,0,True,False
aimo,39,39,0,True,False
angelopiero,39,39,0,True,False
dantedaniele,39,39,0,True,False
ippolita,39,0,39,False,True
danteemilio,39,39,0,True,False
danielevincenzo,39,39,0,True,False
mauretta,39,0,39,False,True
simonepiero,39,39,0,True,False
gianclemente,38,38,0,True,False
brunopaolo,38,38,0,True,False
giacomoremo,38,38,0,True,False
irmgard,38,0,38,False,True
antoniofilippo,38,38,0,True,False
antoninomario,38,38,0,True,False
massimoroberto,38,38,0,True,False
margaret,38,0,38,False,True
tigellio,38,38,0,True,False
vladi,38,38,0,True,False
bortolovalerio,38,38,0,True,False
fiora,38,0,38,False,True
mauriziovincenzo,38,38,0,True,False
accursio,38,38,0,True,False
ildeo,38,38,0,True,False
emiliostefano,38,38,0,True,False
carlalberto,38,38,0,True,False
angelomassimo,38,38,0,True,False
giovannigino,38,38,0,True,False
micheleantonino,38,38,0,True,False
marconatale,38,38,0,True,False
giangiacinto,38,38,0,True,False
mariaemma,38,0,38,False,True
carloenrico,38,38,0,True,False
nathalie,38,0,38,False,True
anello,38,38,0,True,False
angelonicola,38,38,0,True,False
italosalvatore,38,38,0,True,False
giandonato,38,38,0,True,False
gianpalmiro,38,38,0,True,False
marialuigina,38,0,38,False,True
antero,38,38,0,True,False
carlomaurizio,38,38,0,True,False
gianprimo,38,38,0,True,False
vitodonato,38,38,0,True,False
armandoluigi,38,38,0,True,False
emiliogoffredo,38,38,0,True,False
geo,38,38,0,True,False
jimmy,38,38,0,True,False
nancy,38,0,38,False,True
pierosalvatore,38,38,0,True,False
ariosto,38,38,0,True,False
brunoadelino,38,38,0,True,False
georgjosef,38,38,0,True,False
claudiobernardo,38,38,0,True,False
ferruccioprimo,38,38,0,True,False
sigfried,38,38,0,True,False
lucapaolo,38,38,0,True,False
feliciantonio,38,38,0,True,False
emiliagiuseppina,38,0,38,False,True
eutimio,38,38,0,True,False
lucianoamedeo,38,38,0,True,False
crispina,38,0,38,False,True
roccoluciano,38,38,0,True,False
almerindo,38,38,0,True,False
remoaldo,38,38,0,True,False
solidea,38,0,38,False,True
donatomichele,38,38,0,True,False
rebecca,38,0,38,False,True
francoenrico,38,38,0,True,False
pietra,38,0,38,False,True
felicegiuseppe,38,38,0,True,False
levio,38,38,0,True,False
riccardoruggiero,38,38,0,True,False
priscilla,38,3,35,False,True
divo,38,38,0,True,False
evio,38,38,0,True,False
dilvo,38,38,0,True,False
giuseppepompeo,38,38,0,True,False
rosemma,38,0,38,False,True
gabrielemario,38,38,0,True,False
filippino,38,38,0,True,False
lorenzoluigi,38,38,0,True,False
salvatorecarmelo,38,38,0,True,False
alessandromassimo,38,38,0,True,False
spartico,38,38,0,True,False
carminepasquale,38,38,0,True,False
angelarosa,38,2,36,False,True
sabine,38,0,38,False,True
jari,37,37,0,True,False
laviero,37,37,0,True,False
salvatoreignazio,37,37,0,True,False
guidolorenzo,37,37,0,True,False
antoniogesuino,37,37,0,True,False
salvatorerosario,37,37,0,True,False
mariaolimpia,37,0,37,False,True
marioezio,37,37,0,True,False
antonica,37,0,37,False,True
stefanopietro,37,37,0,True,False
fabioalessandro,37,37,0,True,False
donatamaria,37,0,37,False,True
giovanangelo,37,37,0,True,False
giuseppenazzareno,37,37,0,True,False
hermannanton,37,37,0,True,False
giorgioluciano,37,37,0,True,False
brunofelice,37,37,0,True,False
nellocarlo,37,37,0,True,False
francoidio,37,37,0,True,False
nemesio,37,37,0,True,False
augustocesare,37,37,0,True,False
sandronicola,37,37,0,True,False
minella,37,0,37,False,True
paoloaugusto,37,37,0,True,False
aura,37,0,37,False,True
lena,37,0,37,False,True
lella,37,0,37,False,True
galiano,37,37,0,True,False
dariomauro,37,37,0,True,False
alfonsomario,37,37,0,True,False
cisella,37,0,37,False,True
dantino,37,37,0,True,False
antoniosaverio,37,37,0,True,False
barnaba,37,37,0,True,False
francescoferruccio,37,37,0,True,False
alfredogiovanni,37,37,0,True,False
angelosanto,37,37,0,True,False
matteopiernatalino,37,37,0,True,False
davideantonio,37,37,0,True,False
anselmoluigi,37,37,0,True,False
saura,37,0,37,False,True
danilopietro,37,37,0,True,False
tulio,37,37,0,True,False
gianpasquale,37,37,0,True,False
isola,37,0,37,False,True
giovannimarino,37,37,0,True,False
giovannimariano,37,37,0,True,False
ivanomario,37,37,0,True,False
angelamirella,37,0,37,False,True
dalmiro,37,37,0,True,False
michelerosario,37,37,0,True,False
francovellio,37,37,0,True,False
genuino,37,37,0,True,False
giovannidamiano,37,37,0,True,False
luigisergio,37,37,0,True,False
gennarogiovanni,37,37,0,True,False
luigirosario,37,37,0,True,False
giovannidiego,37,37,0,True,False
marialiliana,37,0,37,False,True
antoniofederico,37,37,0,True,False
williams,37,37,0,True,False
giuseppedavide,37,37,0,True,False
pierluisa,37,0,37,False,True
reinhardnorbert,37,37,0,True,False
giuseppandrea,37,37,0,True,False
thomasernst,37,37,0,True,False
querino,37,37,0,True,False
eugeniosalvatore,37,37,0,True,False
redi,37,37,0,True,False
amerino,37,37,0,True,False
giuseppeenzo,37,37,0,True,False
achiropita,37,0,37,False,True
leonio,37,37,0,True,False
antoniociro,37,37,0,True,False
giuseppeezio,37,37,0,True,False
giovannidonato,37,37,0,True,False
pinello,37,37,0,True,False
ioris,36,36,0,True,False
antoninomichele,36,36,0,True,False
lucamassimo,36,36,0,True,False
marianina,36,0,36,False,True
romilio,36,36,0,True,False
mathias,36,36,0,True,False
vitooronzo,36,36,0,True,False
edoardomatteo,36,36,0,True,False
francescangelo,36,36,0,True,False
darioemilio,36,36,0,True,False
sandy,36,1,35,False,True
paololucio,36,36,0,True,False
paoloenrico,36,36,0,True,False
rosaura,36,0,36,False,True
assuntacarmela,36,0,36,False,True
andreasergio,36,36,0,True,False
annapia,36,0,36,False,True
eugeniopatrizio,36,36,0,True,False
marna,36,0,36,False,True
luigiamaria,36,0,36,False,True
salvatorelucio,36,36,0,True,False
eupremio,36,36,0,True,False
luzpaul,36,36,0,True,False
umbertomaria,36,36,0,True,False
udino,36,36,0,True,False
alessandromario,36,36,0,True,False
edimiro,36,36,0,True,False
luz,36,36,0,True,False
josefmaria,36,36,0,True,False
armano,36,36,0,True,False
alexandro,36,36,0,True,False
idolo,36,36,0,True,False
wolfganganton,36,36,0,True,False
giovannirosario,36,36,0,True,False
ernestocarlo,36,36,0,True,False
laurentino,36,36,0,True,False
artenio,36,36,0,True,False
giovannisanto,36,36,0,True,False
rado,36,36,0,True,False
liviomario,36,36,0,True,False
santosalvatore,36,36,0,True,False
daris,36,36,0,True,False
ilariopiercarlo,36,36,0,True,False
trentino,36,36,0,True,False
pascuccio,36,36,0,True,False
annaantonia,36,0,36,False,True
angeloalberto,36,36,0,True,False
damocle,36,36,0,True,False
adrianamaria,36,0,36,False,True
bertino,36,36,0,True,False
antoniocosimo,36,36,0,True,False
peterjohann,36,36,0,True,False
giuseppealessandro,36,36,0,True,False
angelocarlo,36,36,0,True,False
solange,36,0,36,False,True
francogaetano,36,36,0,True,False
carino,36,36,0,True,False
teo,36,36,0,True,False
damianocosimo,36,36,0,True,False
geremiagiuseppe,36,36,0,True,False
maurodomenico,36,36,0,True,False
naldino,36,36,0,True,False
antoniobenito,36,36,0,True,False
dionisia,36,0,36,False,True
marioenzo,36,36,0,True,False
luigifelice,36,36,0,True,False
mariacarlotta,36,0,36,False,True
antonioguglielmo,36,36,0,True,False
dorella,36,0,36,False,True
felicesalvatore,36,36,0,True,False
pasqualesergio,36,36,0,True,False
cosimonicola,36,36,0,True,False
carlofranco,36,36,0,True,False
aldoluigi,36,36,0,True,False
itala,36,0,36,False,True
femio,36,36,0,True,False
pasqualesalvatore,36,36,0,True,False
francescopantaleo,36,36,0,True,False
pasqualenicola,36,36,0,True,False
marioantonino,36,36,0,True,False
valterino,36,33,3,True,False
carloernesto,36,36,0,True,False
silviano,35,35,0,True,False
vanio,35,35,0,True,False
domenicoemilio,35,35,0,True,False
ediemilio,35,35,0,True,False
naldo,35,35,0,True,False
mariafelice,35,0,35,False,True
natalefrancesco,35,35,0,True,False
donatofelice,35,35,0,True,False
maurovalerio,35,35,0,True,False
giuseppepino,35,35,0,True,False
dietrich,35,35,0,True,False
sergioromeo,35,35,0,True,False
ignaziofrancesco,35,35,0,True,False
viktorkarl,35,35,0,True,False
gilmo,35,35,0,True,False
annacarla,35,0,35,False,True
sylvia,35,0,35,False,True
enricocesare,35,35,0,True,False
maurino,35,35,0,True,False
antoniosanto,35,35,0,True,False
vincenzofrancesco,35,35,0,True,False
angelamarialucia,35,0,35,False,True
mariamagdalena,35,0,35,False,True
eno,35,35,0,True,False
adelelmo,35,35,0,True,False
mariaagostina,35,0,35,False,True
apollonia,35,0,35,False,True
giorgiofiorenzo,35,35,0,True,False
giorgiogiacomo,35,35,0,True,False
dionigio,35,35,0,True,False
albertopaolo,35,35,0,True,False
albertolino,35,35,0,True,False
simonefrancesco,35,35,0,True,False
giocondino,35,35,0,True,False
mariagiustina,35,0,35,False,True
albertomassimo,35,35,0,True,False
giorgiomarco,35,35,0,True,False
ferrulio,35,35,0,True,False
antoniodiego,35,35,0,True,False
mariarosina,35,0,35,False,True
enzolivio,35,35,0,True,False
giovannil,35,35,0,True,False
guidoangelo,35,35,0,True,False
dinoluigi,35,35,0,True,False
angelika,35,0,35,False,True
luisamaria,35,0,35,False,True
macario,35,35,0,True,False
alfreda,35,0,35,False,True
rico,35,35,0,True,False
marinoluigi,35,35,0,True,False
luigiorazio,35,35,0,True,False
corino,35,35,0,True,False
jochen,35,35,0,True,False
tazio,35,35,0,True,False
pierlucio,35,35,0,True,False
giuseppeferdinando,35,35,0,True,False
riccardopiero,35,35,0,True,False
richardalois,35,35,0,True,False
angelofausto,35,35,0,True,False
guidoluigi,35,35,0,True,False
pelino,35,35,0,True,False
francoemilio,35,35,0,True,False
tomassino,35,35,0,True,False
robertogabriele,35,35,0,True,False
brigitterosa,35,0,35,False,True
ivomarco,35,35,0,True,False
dalmazzo,35,35,0,True,False
angelogiuseppino,35,35,0,True,False
bindo,35,35,0,True,False
eduilio,35,35,0,True,False
lucioantonio,35,35,0,True,False
camilloantonio,35,35,0,True,False
constantin,35,35,0,True,False
renatoclaudio,35,35,0,True,False
neda,35,0,35,False,True
teseo,35,35,0,True,False
lupo,35,35,0,True,False
hartmut,35,35,0,True,False
perla,35,0,35,False,True
esperia,35,0,35,False,True
josefkarl,35,35,0,True,False
franzwilhelm,35,35,0,True,False
frieda,35,0,35,False,True
carlopasquale,35,35,0,True,False
christophmartin,35,35,0,True,False
carlonicola,35,35,0,True,False
franzthomas,35,35,0,True,False
ciroaniello,35,35,0,True,False
pietroarmando,35,35,0,True,False
andreavalentino,35,35,0,True,False
carlofilippo,35,35,0,True,False
remoluigi,35,35,0,True,False
clement,35,35,0,True,False
joel,35,35,0,True,False
nina,35,0,35,False,True
consiglio,35,35,0,True,False
tommasomario,35,35,0,True,False
edoardoantonino,35,35,0,True,False
emiliogeremia,35,35,0,True,False
rosalucia,35,0,35,False,True
karoline,35,0,35,False,True
catalina,35,0,35,False,True
ottojosef,35,35,0,True,False
rutilio,35,35,0,True,False
roselinde,35,0,35,False,True
mariomassimo,35,35,0,True,False
davidegiorgio,35,35,0,True,False
marinatiziana,35,0,35,False,True
stefanalois,35,35,0,True,False
christiane,35,0,35,False,True
laurent,35,35,0,True,False
gianmarino,35,35,0,True,False
albertogiovanni,35,35,0,True,False
anito,35,35,0,True,False
iames,35,35,0,True,False
giovannisecondo,35,35,0,True,False
rugero,35,35,0,True,False
giovannisaverio,35,35,0,True,False
vitolorenzo,35,35,0,True,False
ettoreluigi,35,35,0,True,False
emiliofrancesco,35,35,0,True,False
lucianoalberto,35,35,0,True,False
maricla,35,0,35,False,True
bengasi,35,35,0,True,False
almerico,35,35,0,True,False
giovannip,35,35,0,True,False
danieleserafino,35,35,0,True,False
alexandra,35,0,35,False,True
rodrigo,35,35,0,True,False
eduardjohann,35,35,0,True,False
gianniguido,35,35,0,True,False
martinorenato,35,35,0,True,False
marie,35,0,35,False,True
angelopaolo,35,35,0,True,False
edmond,35,35,0,True,False
bartolomeocarlo,35,35,0,True,False
giovannigerolamo,34,34,0,True,False
adalino,34,34,0,True,False
gottlieb,34,34,0,True,False
marcofabio,34,34,0,True,False
lamj,34,34,0,True,False
helmutgebhard,34,34,0,True,False
jury,34,34,0,True,False
iglis,34,34,0,True,False
lorenzoenrico,34,34,0,True,False
antiococesare,34,34,0,True,False
alfo,34,34,0,True,False
aldogerardo,34,34,0,True,False
angeloambrogio,34,34,0,True,False
siria,34,0,34,False,True
angelomartino,34,34,0,True,False
angelomarco,34,34,0,True,False
mariaornella,34,0,34,False,True
aldomatteo,34,34,0,True,False
maurofrancesco,34,34,0,True,False
angelogiulio,34,34,0,True,False
luigiettore,34,34,0,True,False
lidano,34,34,0,True,False
mariogavino,34,34,0,True,False
angelogaetano,34,34,0,True,False
aderito,34,34,0,True,False
levis,34,34,0,True,False
inereo,34,34,0,True,False
alduino,34,34,0,True,False
marioalbino,34,34,0,True,False
ulrica,34,0,34,False,True
sveva,34,0,34,False,True
silvina,34,0,34,False,True
guidocarisio,34,34,0,True,False
gisleno,34,34,0,True,False
lothar,34,34,0,True,False
altiero,34,34,0,True,False
gianeusebio,34,34,0,True,False
renzoangelo,34,34,0,True,False
gerardorinaldo,34,34,0,True,False
salvatoreercole,34,34,0,True,False
florestano,34,34,0,True,False
eziomauro,34,34,0,True,False
aldamaria,34,0,34,False,True
paoloagostino,34,34,0,True,False
carloluciano,34,34,0,True,False
attanasio,34,34,0,True,False
darioangelo,34,34,0,True,False
darioalberto,34,34,0,True,False
carlosecondo,34,34,0,True,False
pierbattista,34,34,0,True,False
gianrocco,34,34,0,True,False
eulero,34,34,0,True,False
geneo,34,34,0,True,False
luisagiuseppina,34,0,34,False,True
walterarturo,34,34,0,True,False
gilbert,34,34,0,True,False
pietronicola,34,34,0,True,False
voltero,34,34,0,True,False
carlina,34,0,34,False,True
silver,34,34,0,True,False
pietroromeo,34,34,0,True,False
silvanoedoardo,34,34,0,True,False
pierdiddio,34,34,0,True,False
piergavino,34,34,0,True,False
sebastianopietro,34,34,0,True,False
benino,34,34,0,True,False
camillopietro,34,34,0,True,False
avde,34,0,34,False,True
ivanapatrizia,34,0,34,False,True
avdeiris,34,0,34,False,True
giacomantonio,34,34,0,True,False
ferdiano,34,34,0,True,False
bibiana,34,0,34,False,True
salvatorico,34,34,0,True,False
pasqualefilippo,34,34,0,True,False
gioacchina,34,0,34,False,True
pierogiacomo,34,34,0,True,False
pardino,34,34,0,True,False
annacinzia,34,0,34,False,True
faustosalvatore,34,34,0,True,False
gerold,34,34,0,True,False
carmeloantonino,34,34,0,True,False
brizio,34,34,0,True,False
valterdomenico,34,34,0,True,False
ermenegildogiovanni,34,34,0,True,False
mariabernardina,34,0,34,False,True
vero,34,34,0,True,False
ponziano,34,34,0,True,False
giovannienzo,34,34,0,True,False
vitoonofrio,34,34,0,True,False
rodolfogiuliano,34,34,0,True,False
remiro,34,34,0,True,False
mariaignazia,34,0,34,False,True
dantefabiano,34,34,0,True,False
renatoferdinando,34,34,0,True,False
gaetanoivan,34,34,0,True,False
nisio,34,34,0,True,False
vincenzoamedeo,34,34,0,True,False
emilioandrea,34,34,0,True,False
romanopaolo,34,34,0,True,False
piogiovanni,34,34,0,True,False
nicandroantonio,34,34,0,True,False
eloisa,34,0,34,False,True
valterantonio,34,34,0,True,False
marella,34,0,34,False,True
odelio,34,34,0,True,False
araldo,34,34,0,True,False
vittoriomario,34,34,0,True,False
antoniograziano,34,34,0,True,False
cristoforoluciano,34,34,0,True,False
villi,34,34,0,True,False
salima,33,0,33,False,True
fiorenzogiuseppe,33,33,0,True,False
getulio,33,33,0,True,False
rosarioclaudio,33,33,0,True,False
luigifilippo,33,33,0,True,False
donatellamaria,33,0,33,False,True
santosaverio,33,33,0,True,False
francovincenzo,33,33,0,True,False
giacomodario,33,33,0,True,False
natala,33,0,33,False,True
giacomomichele,33,33,0,True,False
pierleandro,33,33,0,True,False
calisto,33,33,0,True,False
alvisio,33,33,0,True,False
marioaugusto,33,33,0,True,False
domenicoaldo,33,33,0,True,False
pieremidio,33,33,0,True,False
franconicola,33,33,0,True,False
liviogiuseppe,33,33,0,True,False
dainella,33,0,33,False,True
demos,33,33,0,True,False
robertosecondo,33,33,0,True,False
andreagiosue',33,33,0,True,False
malio,33,33,0,True,False
malvino,33,33,0,True,False
gasparevalter,33,33,0,True,False
pioercole,33,33,0,True,False
rosello,33,33,0,True,False
francescofiore,33,33,0,True,False
marcellomario,33,33,0,True,False
pietroermenegildo,33,33,0,True,False
ondina,33,0,33,False,True
marcelloroberto,33,33,0,True,False
pietrobruno,33,33,0,True,False
marcoaurelio,33,33,0,True,False
pietroalfredo,33,33,0,True,False
rolandwalter,33,33,0,True,False
francantonio,33,33,0,True,False
davidepaolo,33,33,0,True,False
pasquina,33,0,33,False,True
anelio,33,33,0,True,False
carminevito,33,33,0,True,False
roswitha,33,0,33,False,True
claudioagostino,33,33,0,True,False
claudioluciano,33,33,0,True,False
carloumberto,33,33,0,True,False
ramiro,33,33,0,True,False
angelogiuliano,33,33,0,True,False
letteria,33,0,33,False,True
emerenziano,33,33,0,True,False
mariasimona,33,0,33,False,True
mariassunta,33,2,31,False,True
tomasocarlo,33,33,0,True,False
olidio,33,33,0,True,False
olivano,33,33,0,True,False
oronzomaurizio,33,33,0,True,False
wilson,33,33,0,True,False
arnaldogiuseppe,33,33,0,True,False
osvaldonicola,33,33,0,True,False
guidomario,33,33,0,True,False
ottavioaugusto,33,33,0,True,False
efisiomaria,33,33,0,True,False
eziogiuseppe,33,33,0,True,False
giannico,33,33,0,True,False
antoniotito,33,33,0,True,False
antoniotiberio,33,33,0,True,False
vittoriofrancesco,33,33,0,True,False
vincenzopietro,33,33,0,True,False
giovanniernesto,33,33,0,True,False
michelecamillomari,33,33,0,True,False
moritz,33,33,0,True,False
vannuccio,33,33,0,True,False
giovandomenico,33,33,0,True,False
adorino,33,33,0,True,False
enzomaria,33,33,0,True,False
massimovincenzo,33,33,0,True,False
nicolaalessandro,33,33,0,True,False
emiliovittorio,33,33,0,True,False
vitolucio,33,33,0,True,False
idalio,33,33,0,True,False
vitorosario,33,33,0,True,False
vittoriodomenico,33,33,0,True,False
edoardoluigi,33,33,0,True,False
aldofranco,33,33,0,True,False
mariogabriele,33,33,0,True,False
giusepperomano,33,33,0,True,False
benedettomario,33,33,0,True,False
benedettoantonio,33,33,0,True,False
domenicodamiano,33,33,0,True,False
serafin,33,33,0,True,False
angelomarcello,33,33,0,True,False
giulianoantonio,33,33,0,True,False
sestogiovanni,33,33,0,True,False
pierambrogio,33,33,0,True,False
iride,33,0,33,False,True
mariopiero,33,33,0,True,False
ausonio,33,33,0,True,False
domenicoangelo,33,33,0,True,False
mariorino,33,33,0,True,False
luigiaugusto,32,32,0,True,False
corradoluigi,32,32,0,True,False
renzoraffaele,32,32,0,True,False
francesconatale,32,32,0,True,False
savinomodesto,32,32,0,True,False
ali,32,32,0,True,False
crescenza,32,0,32,False,True
selena,32,0,32,False,True
luigicesare,32,32,0,True,False
ilvio,32,32,0,True,False
dea,32,0,32,False,True
dalio,32,32,0,True,False
custode,32,32,0,True,False
ilarioantonio,32,32,0,True,False
antoniella,32,0,32,False,True
livioantonio,32,32,0,True,False
riccardoattilio,32,32,0,True,False
enrichetto,32,32,0,True,False
vittoriamaria,32,0,32,False,True
enricoalessandro,32,32,0,True,False
doadi,32,32,0,True,False
guidogiuseppe,32,32,0,True,False
agenore,32,32,0,True,False
florideo,32,32,0,True,False
donatuccio,32,32,0,True,False
stefanoandrea,32,32,0,True,False
rosemarie,32,0,32,False,True
fabrizioalessandro,32,32,0,True,False
albertoegidio,32,32,0,True,False
faustoangelo,32,32,0,True,False
terzilio,32,32,0,True,False
fernandomario,32,32,0,True,False
elioclaudio,32,32,0,True,False
giusppe,32,32,0,True,False
domenicosanti,32,32,0,True,False
albertotullio,32,32,0,True,False
titolivio,32,32,0,True,False
emanuelepietro,32,32,0,True,False
bortolina,32,1,31,False,True
albinopaolo,32,32,0,True,False
domenicopasquale,32,32,0,True,False
domenicogerardo,32,32,0,True,False
alfonsorosario,32,32,0,True,False
silveria,32,0,32,False,True
volfango,32,32,0,True,False
sandrogino,32,32,0,True,False
selso,32,32,0,True,False
rose,32,0,32,False,True
ilmo,32,32,0,True,False
marcougo,32,32,0,True,False
novaro,32,32,0,True,False
marcorino,32,32,0,True,False
massimopaolo,32,32,0,True,False
jane,32,0,32,False,True
odone,32,32,0,True,False
carloenea,32,32,0,True,False
gerardogiovanni,32,32,0,True,False
mariogerardo,32,32,0,True,False
pietrosergio,32,32,0,True,False
marcoegidio,32,32,0,True,False
mariaromana,32,0,32,False,True
odetta,32,0,32,False,True
gioni,32,32,0,True,False
gianpietromatteo,32,32,0,True,False
pietropasquale,32,32,0,True,False
marcovinicio,32,32,0,True,False
nelli,32,0,32,False,True
ofelio,32,32,0,True,False
gianfederico,32,32,0,True,False
marcovittorio,32,32,0,True,False
antoninoluciano,32,32,0,True,False
olivier,32,32,0,True,False
giorgetta,32,0,32,False,True
camillodonato,32,32,0,True,False
giacomoangelo,32,32,0,True,False
oscarino,32,32,0,True,False
giancarlopasquale,32,32,0,True,False
giampieromaria,32,32,0,True,False
lorenzaelena,32,0,32,False,True
pierbartolo,32,32,0,True,False
angelolorenzo,32,32,0,True,False
armandomarcellino,32,32,0,True,False
carmelogiovanni,32,32,0,True,False
andrealuca,32,32,0,True,False
mathilde,32,0,32,False,True
nicasio,32,32,0,True,False
amanto,32,32,0,True,False
renatogiovanni,32,32,0,True,False
mimino,32,32,0,True,False
clodomiro,32,32,0,True,False
morando,32,32,0,True,False
amedeobasilio,32,32,0,True,False
giovannileonardo,32,32,0,True,False
antoniocalogero,32,32,0,True,False
katya,32,0,32,False,True
natalio,32,32,0,True,False
paolobattista,32,32,0,True,False
antoniomaurizio,32,32,0,True,False
pardo,32,32,0,True,False
biondo,32,32,0,True,False
raffaelemichele,32,32,0,True,False
mauramaria,32,0,32,False,True
augustobiagio,32,32,0,True,False
pasqualeluigi,32,32,0,True,False
gabrieleemanuele,32,32,0,True,False
fabia,32,0,32,False,True
mariogiorgio,32,32,0,True,False
ottavianoaugusto,31,31,0,True,False
elvisio,31,31,0,True,False
egidiogiovanni,31,31,0,True,False
eleutherios,31,31,0,True,False
silviomario,31,31,0,True,False
palerio,31,31,0,True,False
gianlucagiuseppe,31,31,0,True,False
guidomartino,31,31,0,True,False
elioangelo,31,31,0,True,False
avernino,31,31,0,True,False
mariosantino,31,31,0,True,False
simoneluigi,31,31,0,True,False
giannimauro,31,31,0,True,False
lidiana,31,0,31,False,True
leonella,31,0,31,False,True
kassian,31,31,0,True,False
linacaterina,31,0,31,False,True
renzino,31,31,0,True,False
emanuelegiuseppe,31,31,0,True,False
maurocataldo,31,31,0,True,False
enzino,31,31,0,True,False
enricofranco,31,31,0,True,False
mariamichelina,31,0,31,False,True
nannino,31,31,0,True,False
narcisio,31,31,0,True,False
antoniogianfranco,31,31,0,True,False
marianovella,31,0,31,False,True
enzoluigino,31,31,0,True,False
antoniobiagio,31,31,0,True,False
mariacatia,31,0,31,False,True
irvano,31,31,0,True,False
valeriofranco,31,31,0,True,False
niccolo,31,31,0,True,False
enzotonino,31,31,0,True,False
udalrico,31,31,0,True,False
luciaantonietta,31,0,31,False,True
nicolacarlo,31,31,0,True,False
giordanoluigi,31,31,0,True,False
ernino,31,31,0,True,False
ivanantonio,31,31,0,True,False
mariaraimonda,31,0,31,False,True
giovannimattia,31,31,0,True,False
nordio,31,31,0,True,False
ettoreserafino,31,31,0,True,False
lauracarla,31,0,31,False,True
mariastefana,31,0,31,False,True
ariano,31,31,0,True,False
tizianoonorio,31,31,0,True,False
eugeniocarlo,31,31,0,True,False
waltermaria,31,31,0,True,False
anacleta,31,0,31,False,True
mariogianni,31,31,0,True,False
silvanogiovanni,31,31,0,True,False
dominik,31,31,0,True,False
luigisilvio,31,31,0,True,False
danielesecondo,31,31,0,True,False
evamaria,31,0,31,False,True
faustamaria,31,0,31,False,True
gaetanomichele,31,31,0,True,False
carminegiovanni,31,31,0,True,False
francescofilippo,31,31,0,True,False
francescateresa,31,0,31,False,True
marcellogiuseppe,31,31,0,True,False
franziska,31,0,31,False,True
rubes,31,31,0,True,False
geppino,31,31,0,True,False
florigi,31,31,0,True,False
pietrinogiuseppe,31,31,0,True,False
carloeugenio,31,31,0,True,False
danielegiovanni,31,31,0,True,False
cristinaannamaria,31,0,31,False,True
roccoalberto,31,31,0,True,False
cirodonato,31,31,0,True,False
eletta,31,0,31,False,True
dorothea,31,0,31,False,True
francofelice,31,31,0,True,False
robertoenrico,31,31,0,True,False
francoroberto,31,31,0,True,False
americodomenico,31,31,0,True,False
erina,31,0,31,False,True
raffaelepasquale,31,31,0,True,False
christianfrancesco,31,31,0,True,False
danielle,31,0,31,False,True
mariakatia,31,0,31,False,True
luigicarmelo,31,31,0,True,False
robledo,31,31,0,True,False
francescovittorio,31,31,0,True,False
piersante,31,31,0,True,False
pierodante,31,31,0,True,False
angeloarturo,31,31,0,True,False
annafranca,31,0,31,False,True
pasqualeorazio,31,31,0,True,False
giuseppeteresio,31,31,0,True,False
silvestramaria,31,0,31,False,True
giuseppefederico,31,31,0,True,False
angelorocco,31,31,0,True,False
pasqualefranco,31,31,0,True,False
angeloserafino,31,31,0,True,False
giuseppesergio,31,31,0,True,False
leopoldino,31,31,0,True,False
katja,31,0,31,False,True
grato,31,31,0,True,False
paoloonofrio,31,31,0,True,False
stefaniamaria,31,0,31,False,True
leonardovincenzo,31,31,0,True,False
annetta,31,0,31,False,True
antonellarita,31,0,31,False,True
fioravanti,31,31,0,True,False
giacomowalter,31,31,0,True,False
biagina,31,0,31,False,True
filippogiacomo,31,31,0,True,False
gioietta,31,0,31,False,True
livioedoardo,31,31,0,True,False
pierinoangelo,31,31,0,True,False
saveriofrancesco,31,31,0,True,False
gudrun,31,0,31,False,True
bennardo,31,31,0,True,False
aldomaria,31,31,0,True,False
mirka,31,0,31,False,True
domenicobruno,31,31,0,True,False
giancarlomichele,31,31,0,True,False
giuseppesantino,31,31,0,True,False
sebastianosalvatore,31,31,0,True,False
giovanniezio,31,31,0,True,False
